county,fips,date,total_cases,new_cases,total_confirmed,new_confirmed,total_probable,new_probable,pos_tests,new_pos_tests,neg_tests,new_neg_tests,total_tests,new_tests,new_deaths,total_deaths,new_hospitalized,total_hospitalized,total_deaths_by_dod,new_deaths_by_dod
Davidson,47037,5/21/2022,196840,167,176424,136,20416,31,207399,175,1583190,609,1790589,784,0,1686,0,3907,1687,0
Davidson,47037,5/20/2022,196673,234,176288,188,20385,46,207224,211,1582581,904,1789805,1115,0,1686,0,3907,1687,0
Davidson,47037,5/19/2022,196439,280,176100,231,20339,49,207013,250,1581677,996,1788690,1246,1,1686,1,3907,1687,0
Davidson,47037,5/18/2022,196159,188,175869,151,20290,37,206763,184,1580681,673,1787444,857,-1,1685,0,3906,1687,0
Davidson,47037,5/17/2022,195971,287,175718,207,20253,80,206579,223,1580008,906,1786587,1129,6,1686,0,3906,1687,0
Davidson,47037,5/16/2022,195684,185,175511,153,20173,32,206356,171,1579102,707,1785458,878,1,1680,0,3906,1687,0
Davidson,47037,5/15/2022,195499,106,175358,89,20141,17,206185,100,1578395,439,1784580,539,0,1679,0,3906,1687,0
Davidson,47037,5/14/2022,195393,113,175269,101,20124,12,206085,111,1577956,446,1784041,557,0,1679,0,3906,1687,0
Davidson,47037,5/13/2022,195280,238,175168,181,20112,57,205974,205,1577510,1041,1783484,1246,0,1679,0,3906,1687,0
Davidson,47037,5/12/2022,195042,211,174987,168,20055,43,205769,176,1576469,916,1782238,1092,1,1679,0,3906,1687,0
Davidson,47037,5/11/2022,194831,169,174819,144,20012,25,205593,157,1575553,748,1781146,905,0,1678,1,3906,1687,0
Davidson,47037,5/10/2022,194662,212,174675,167,19987,45,205436,196,1574805,979,1780241,1175,0,1678,1,3905,1687,0
Davidson,47037,5/9/2022,194450,167,174508,141,19942,26,205240,153,1573826,600,1779066,753,4,1678,0,3904,1687,0
Davidson,47037,5/8/2022,194283,79,174367,66,19916,13,205087,75,1573226,400,1778313,475,0,1674,0,3904,1687,1
Davidson,47037,5/7/2022,194204,102,174301,90,19903,12,205012,112,1572826,535,1777838,647,0,1674,2,3904,1686,0
Davidson,47037,5/6/2022,194102,189,174211,156,19891,33,204900,163,1572291,902,1777191,1065,0,1674,0,3902,1686,0
Davidson,47037,5/5/2022,193913,145,174055,122,19858,23,204737,138,1571389,907,1776126,1045,1,1674,0,3902,1686,1
Davidson,47037,5/4/2022,193768,148,173933,132,19835,16,204599,145,1570482,991,1775081,1136,0,1673,0,3902,1685,0
Davidson,47037,5/3/2022,193620,148,173801,120,19819,28,204454,134,1569491,767,1773945,901,-1,1673,1,3902,1685,0
Davidson,47037,5/2/2022,193472,107,173681,83,19791,24,204320,100,1568724,629,1773044,729,1,1674,1,3901,1685,0
Davidson,47037,5/1/2022,193365,37,173598,35,19767,2,204220,37,1568095,301,1772315,338,0,1673,0,3900,1685,0
Davidson,47037,4/30/2022,193328,72,173563,62,19765,10,204183,76,1567794,430,1771977,506,0,1673,2,3900,1685,0
Davidson,47037,4/29/2022,193256,133,173501,116,19755,17,204107,139,1567364,1034,1771471,1173,0,1673,1,3898,1685,0
Davidson,47037,4/28/2022,193123,141,173385,111,19738,30,203968,124,1566330,937,1770298,1061,2,1673,1,3897,1685,0
Davidson,47037,4/27/2022,192982,109,173274,86,19708,23,203844,95,1565393,895,1769237,990,0,1671,1,3896,1685,1
Davidson,47037,4/26/2022,192873,123,173188,112,19685,11,203749,135,1564498,1131,1768247,1266,0,1671,1,3895,1684,1
Davidson,47037,4/25/2022,192750,87,173076,68,19674,19,203614,80,1563367,791,1766981,871,0,1671,0,3894,1683,0
Davidson,47037,4/24/2022,192663,33,173008,30,19655,3,203534,36,1562576,412,1766110,448,0,1671,0,3894,1683,0
Davidson,47037,4/23/2022,192630,50,172978,46,19652,4,203498,59,1562164,744,1765662,803,0,1671,0,3894,1683,0
Davidson,47037,4/22/2022,192580,118,172932,101,19648,17,203439,108,1561420,813,1764859,921,0,1671,0,3894,1683,0
Davidson,47037,4/21/2022,192462,96,172831,78,19631,18,203331,86,1560607,1156,1763938,1242,3,1671,1,3894,1683,0
Davidson,47037,4/20/2022,192366,123,172753,98,19613,25,203245,111,1559451,981,1762696,1092,1,1668,0,3893,1683,1
Davidson,47037,4/19/2022,192243,88,172655,71,19588,17,203134,81,1558470,990,1761604,1071,0,1667,1,3893,1682,1
Davidson,47037,4/18/2022,192155,50,172584,46,19571,4,203053,49,1557480,552,1760533,601,-1,1667,0,3892,1681,0
Davidson,47037,4/17/2022,192105,43,172538,42,19567,1,203004,48,1556928,281,1759932,329,0,1668,1,3892,1681,0
Davidson,47037,4/16/2022,192062,53,172496,50,19566,3,202956,55,1556647,409,1759603,464,0,1668,1,3891,1681,0
Davidson,47037,4/15/2022,192009,70,172446,63,19563,7,202901,72,1556238,858,1759139,930,0,1668,0,3890,1681,0
Davidson,47037,4/14/2022,191939,91,172383,77,19556,14,202829,73,1555380,830,1758209,903,1,1668,0,3890,1681,0
Davidson,47037,4/13/2022,191848,95,172306,80,19542,15,202756,86,1554550,997,1757306,1083,0,1667,0,3890,1681,0
Davidson,47037,4/12/2022,191753,64,172226,48,19527,16,202670,54,1553553,752,1756223,806,4,1667,0,3890,1681,0
Davidson,47037,4/11/2022,191689,60,172178,53,19511,7,202616,52,1552801,574,1755417,626,2,1663,0,3890,1681,0
Davidson,47037,4/10/2022,191629,16,172125,14,19504,2,202564,19,1552227,230,1754791,249,-1,1661,0,3890,1681,0
Davidson,47037,4/9/2022,191613,28,172111,26,19502,2,202545,32,1551997,693,1754542,725,0,1662,0,3890,1681,1
Davidson,47037,4/8/2022,191585,60,172085,56,19500,4,202513,58,1551304,1090,1753817,1148,0,1662,0,3890,1680,1
Davidson,47037,4/7/2022,191525,60,172029,47,19496,13,202455,51,1550214,655,1752669,706,8,1662,1,3890,1679,0
Davidson,47037,4/6/2022,191465,61,171982,53,19483,8,202404,66,1549559,943,1751963,1009,0,1654,1,3889,1679,0
Davidson,47037,4/5/2022,191404,62,171929,50,19475,12,202338,54,1548616,738,1750954,792,4,1654,0,3888,1679,1
Davidson,47037,4/4/2022,191342,39,171879,32,19463,7,202284,34,1547878,851,1750162,885,9,1650,0,3888,1678,0
Davidson,47037,4/3/2022,191303,14,171847,12,19456,2,202250,12,1547027,348,1749277,360,1,1641,0,3888,1678,0
Davidson,47037,4/2/2022,191289,17,171835,17,19454,0,202238,19,1546679,484,1748917,503,0,1640,0,3888,1678,0
Davidson,47037,4/1/2022,191272,40,171818,31,19454,9,202219,35,1546195,874,1748414,909,0,1640,0,3888,1678,2
Davidson,47037,3/31/2022,191232,43,171787,35,19445,8,202184,36,1545321,893,1747505,929,2,1640,0,3888,1676,1
Davidson,47037,3/30/2022,191189,44,171752,36,19437,8,202148,35,1544428,1116,1746576,1151,0,1638,0,3888,1675,2
Davidson,47037,3/29/2022,191145,31,171716,28,19429,3,202113,33,1543312,731,1745425,764,4,1638,1,3888,1673,0
Davidson,47037,3/28/2022,191114,49,171688,40,19426,9,202080,45,1542581,1090,1744661,1135,1,1634,0,3887,1673,0
Davidson,47037,3/27/2022,191065,15,171648,9,19417,6,202035,13,1541491,274,1743526,287,0,1633,0,3887,1673,0
Davidson,47037,3/26/2022,191050,28,171639,23,19411,5,202022,27,1541217,750,1743239,777,0,1633,0,3887,1673,1
Davidson,47037,3/25/2022,191022,33,171616,30,19406,3,201995,34,1540467,1066,1742462,1100,0,1633,0,3887,1672,3
Davidson,47037,3/24/2022,190989,35,171586,30,19403,5,201961,34,1539401,745,1741362,779,2,1633,0,3887,1669,0
Davidson,47037,3/23/2022,190954,47,171556,40,19398,7,201927,45,1538656,988,1740583,1033,2,1631,1,3887,1669,0
Davidson,47037,3/22/2022,190907,60,171516,38,19391,22,201882,45,1537668,919,1739550,964,1,1629,0,3886,1669,0
Davidson,47037,3/21/2022,190847,38,171478,32,19369,6,201837,35,1536749,806,1738586,841,-1,1628,0,3886,1669,1
Davidson,47037,3/20/2022,190809,21,171446,20,19363,1,201802,21,1535943,332,1737745,353,0,1629,0,3886,1668,0
Davidson,47037,3/19/2022,190788,23,171426,18,19362,5,201781,20,1535611,740,1737392,760,0,1629,0,3886,1668,1
Davidson,47037,3/18/2022,190765,33,171408,31,19357,2,201761,36,1534871,943,1736632,979,0,1629,0,3886,1667,1
Davidson,47037,3/17/2022,190732,43,171377,35,19355,8,201725,39,1533928,915,1735653,954,2,1629,0,3886,1666,1
Davidson,47037,3/16/2022,190689,45,171342,33,19347,12,201686,41,1533013,1006,1734699,1047,0,1627,0,3886,1665,1
Davidson,47037,3/15/2022,190644,31,171309,24,19335,7,201645,30,1532007,923,1733652,953,0,1627,1,3886,1664,0
Davidson,47037,3/14/2022,190613,62,171285,41,19328,21,201615,48,1531084,820,1732699,868,7,1627,3,3885,1664,0
Davidson,47037,3/13/2022,190551,15,171244,13,19307,2,201567,17,1530264,551,1731831,568,0,1620,0,3882,1664,0
Davidson,47037,3/12/2022,190536,16,171231,12,19305,4,201550,16,1529713,639,1731263,655,0,1620,1,3882,1664,2
Davidson,47037,3/11/2022,190520,31,171219,28,19301,3,201534,32,1529074,1145,1730608,1177,10,1620,0,3881,1662,2
Davidson,47037,3/10/2022,190489,58,171191,47,19298,11,201502,48,1527929,1192,1729431,1240,7,1610,1,3881,1660,1
Davidson,47037,3/9/2022,190431,58,171144,48,19287,10,201454,59,1526737,1317,1728191,1376,2,1603,1,3880,1659,1
Davidson,47037,3/8/2022,190373,126,171096,51,19277,75,201395,51,1525420,870,1726815,921,1,1601,1,3879,1658,0
Davidson,47037,3/7/2022,190247,61,171045,52,19202,9,201344,61,1524550,1020,1725894,1081,3,1600,1,3878,1658,2
Davidson,47037,3/6/2022,190186,26,170993,14,19193,12,201283,24,1523530,442,1724813,466,0,1597,1,3877,1656,2
Davidson,47037,3/5/2022,190160,25,170979,24,19181,1,201259,33,1523088,613,1724347,646,1,1597,0,3876,1654,3
Davidson,47037,3/4/2022,190135,76,170955,58,19180,18,201226,77,1522475,1418,1723701,1495,1,1596,1,3876,1651,2
Davidson,47037,3/3/2022,190059,51,170897,43,19162,8,201149,52,1521057,914,1722206,966,3,1595,0,3875,1649,1
Davidson,47037,3/2/2022,190008,118,170854,100,19154,18,201097,114,1520143,1579,1721240,1693,5,1592,1,3875,1648,2
Davidson,47037,3/1/2022,189890,99,170754,73,19136,26,200983,88,1518564,1125,1719547,1213,4,1587,0,3874,1646,3
Davidson,47037,2/28/2022,189791,133,170681,100,19110,33,200895,124,1517439,1118,1718334,1242,1,1583,1,3874,1643,1
Davidson,47037,2/27/2022,189658,17,170581,17,19077,0,200771,17,1516321,264,1717092,281,2,1582,1,3873,1642,0
Davidson,47037,2/26/2022,189641,77,170564,65,19077,12,200754,86,1516057,771,1716811,857,0,1580,2,3872,1642,1
Davidson,47037,2/25/2022,189564,110,170499,92,19065,18,200668,107,1515286,1523,1715954,1630,1,1580,1,3870,1641,2
Davidson,47037,2/24/2022,189454,125,170407,102,19047,23,200561,118,1513763,1051,1714324,1169,6,1579,0,3869,1639,5
Davidson,47037,2/23/2022,189329,178,170305,146,19024,32,200443,168,1512712,1398,1713155,1566,6,1573,4,3869,1634,3
Davidson,47037,2/22/2022,189151,156,170159,124,18992,32,200275,141,1511314,1060,1711589,1201,2,1567,1,3865,1631,1
Davidson,47037,2/21/2022,188995,106,170035,90,18960,16,200134,111,1510254,750,1710388,861,1,1565,1,3864,1630,1
Davidson,47037,2/20/2022,188889,76,169945,60,18944,16,200023,74,1509504,518,1709527,592,0,1564,1,3863,1629,4
Davidson,47037,2/19/2022,188813,101,169885,89,18928,12,199949,113,1508986,615,1708935,728,4,1564,3,3862,1625,2
Davidson,47037,2/18/2022,188712,167,169796,140,18916,27,199836,179,1508371,1464,1708207,1643,1,1560,0,3859,1623,2
Davidson,47037,2/17/2022,188545,188,169656,150,18889,38,199657,175,1506907,976,1706564,1151,1,1559,5,3859,1621,4
Davidson,47037,2/16/2022,188357,248,169506,208,18851,40,199482,247,1505931,1636,1705413,1883,3,1558,3,3854,1617,2
Davidson,47037,2/15/2022,188109,216,169298,160,18811,56,199235,193,1504295,1035,1703530,1228,7,1555,4,3851,1615,3
Davidson,47037,2/14/2022,187893,266,169138,222,18755,44,199042,298,1503260,1305,1702302,1603,18,1548,0,3847,1612,3
Davidson,47037,2/13/2022,187627,95,168916,71,18711,24,198744,86,1501955,415,1700699,501,5,1530,0,3847,1609,3
Davidson,47037,2/12/2022,187532,166,168845,154,18687,12,198658,199,1501540,710,1700198,909,0,1525,0,3847,1606,3
Davidson,47037,2/11/2022,187366,332,168691,265,18675,67,198459,313,1500830,1590,1699289,1903,5,1525,1,3847,1603,8
Davidson,47037,2/10/2022,187034,405,168426,340,18608,65,198146,404,1499240,1729,1697386,2133,2,1520,1,3846,1595,2
Davidson,47037,2/9/2022,186629,444,168086,386,18543,58,197742,432,1497511,1814,1695253,2246,4,1518,3,3845,1593,3
Davidson,47037,2/8/2022,186185,452,167700,362,18485,90,197310,449,1495697,1382,1693007,1831,3,1514,3,3842,1590,6
Davidson,47037,2/7/2022,185733,434,167338,327,18395,107,196861,386,1494315,1585,1691176,1971,3,1511,3,3839,1584,4
Davidson,47037,2/6/2022,185299,217,167011,183,18288,34,196475,216,1492730,597,1689205,813,1,1508,2,3836,1580,3
Davidson,47037,2/5/2022,185082,281,166828,242,18254,39,196259,283,1492133,733,1688392,1016,1,1507,0,3834,1577,5
Davidson,47037,2/4/2022,184801,656,166586,577,18215,79,195976,672,1491400,2203,1687376,2875,7,1506,6,3834,1572,2
Davidson,47037,2/3/2022,184145,621,166009,480,18136,141,195304,560,1489197,1464,1684501,2024,3,1499,2,3828,1570,7
Davidson,47037,2/2/2022,183524,803,165529,680,17995,123,194744,810,1487733,2322,1682477,3132,2,1496,3,3826,1563,4
Davidson,47037,2/1/2022,182721,962,164849,865,17872,97,193934,1001,1485411,1922,1679345,2923,6,1494,4,3823,1559,3
Davidson,47037,1/31/2022,181759,680,163984,570,17775,110,192933,642,1483489,1425,1676422,2067,10,1488,4,3819,1556,7
Davidson,47037,1/30/2022,181079,394,163414,346,17665,48,192291,399,1482064,995,1674355,1394,2,1478,4,3815,1549,3
Davidson,47037,1/29/2022,180685,729,163068,663,17617,66,191892,806,1481069,1848,1672961,2654,0,1476,0,3811,1546,5
Davidson,47037,1/28/2022,179956,1051,162405,935,17551,116,191086,1043,1479221,1985,1670307,3028,9,1476,3,3811,1541,3
Davidson,47037,1/27/2022,178905,976,161470,812,17435,164,190043,908,1477236,2120,1667279,3028,5,1467,6,3808,1538,5
Davidson,47037,1/26/2022,177929,1145,160658,986,17271,159,189135,1122,1475116,2232,1664251,3354,6,1462,2,3802,1533,9
Davidson,47037,1/25/2022,176784,1337,159672,1194,17112,143,188013,1221,1472884,1826,1660897,3047,4,1456,7,3800,1524,4
Davidson,47037,1/24/2022,175447,1302,158478,1105,16969,197,186792,1230,1471058,2210,1657850,3440,9,1452,8,3793,1520,6
Davidson,47037,1/23/2022,174145,668,157373,595,16772,73,185562,671,1468848,1280,1654410,1951,0,1443,3,3785,1514,6
Davidson,47037,1/22/2022,173477,1006,156778,909,16699,97,184891,1016,1467568,1793,1652459,2809,0,1443,1,3782,1508,8
Davidson,47037,1/21/2022,172471,1187,155869,1046,16602,141,183875,1200,1465775,2492,1649650,3692,6,1443,1,3781,1500,4
Davidson,47037,1/20/2022,171284,1566,154823,1398,16461,168,182675,1465,1463283,2231,1645958,3696,5,1437,4,3780,1496,1
Davidson,47037,1/19/2022,169718,2371,153425,2080,16293,291,181210,2272,1461052,3766,1642262,6038,7,1432,9,3776,1495,7
Davidson,47037,1/18/2022,167347,1062,151345,842,16002,220,178938,901,1457286,1399,1636224,2300,5,1425,7,3767,1488,3
Davidson,47037,1/17/2022,166285,672,150503,567,15782,105,178037,552,1455887,703,1633924,1255,1,1420,8,3760,1485,5
Davidson,47037,1/16/2022,165613,1266,149936,1178,15677,88,177485,1369,1455184,2494,1632669,3863,3,1419,6,3752,1480,7
Davidson,47037,1/15/2022,164347,1338,148758,1211,15589,127,176116,1372,1452690,2070,1628806,3442,3,1416,11,3746,1473,2
Davidson,47037,1/14/2022,163009,2072,147547,1778,15462,294,174744,1955,1450620,2861,1625364,4816,9,1413,7,3735,1471,7
Davidson,47037,1/13/2022,160937,1916,145769,1645,15168,271,172789,1849,1447759,2656,1620548,4505,9,1404,16,3728,1464,3
Davidson,47037,1/12/2022,159021,1587,144124,1366,14897,221,170940,1548,1445103,2815,1616043,4363,3,1395,8,3712,1461,4
Davidson,47037,1/11/2022,157434,1832,142758,1584,14676,248,169392,1664,1442288,2092,1611680,3756,1,1392,12,3704,1457,6
Davidson,47037,1/10/2022,155602,1469,141174,1243,14428,226,167728,1350,1440196,1615,1607924,2965,4,1391,14,3692,1451,1
Davidson,47037,1/9/2022,154133,697,139931,577,14202,120,166378,630,1438581,812,1604959,1442,3,1387,12,3678,1450,5
Davidson,47037,1/8/2022,153436,1014,139354,933,14082,81,165748,1019,1437769,1361,1603517,2380,0,1384,13,3666,1445,3
Davidson,47037,1/7/2022,152422,1762,138421,1641,14001,121,164729,1079,1436408,2594,1601137,3673,2,1384,6,3653,1442,4
Davidson,47037,1/6/2022,150660,2846,136780,2517,13880,329,163650,2716,1433814,3737,1597464,6453,1,1382,15,3647,1438,3
Davidson,47037,1/5/2022,147814,2503,134263,2124,13551,379,160934,2127,1430077,2633,1591011,4760,4,1381,12,3632,1435,3
Davidson,47037,1/4/2022,145311,1896,132139,1607,13172,289,158807,1823,1427444,2789,1586251,4612,0,1377,10,3620,1432,6
Davidson,47037,1/3/2022,143415,955,130532,825,12883,130,156984,846,1424655,1208,1581639,2054,2,1377,8,3610,1426,3
Davidson,47037,1/2/2022,142460,774,129707,621,12753,153,156138,672,1423447,1223,1579585,1895,0,1375,7,3602,1423,2
Davidson,47037,1/1/2022,141686,1686,129086,1640,12600,46,155466,1962,1422224,3059,1577690,5021,0,1375,8,3595,1421,1
Davidson,47037,12/31/2021,140000,1294,127446,1154,12554,140,153504,1248,1419165,2478,1572669,3726,-1,1375,5,3587,1420,1
Davidson,47037,12/30/2021,138706,2622,126292,2355,12414,267,152256,2698,1416687,3443,1568943,6141,1,1376,11,3582,1419,1
Davidson,47037,12/29/2021,136084,1634,123937,1399,12147,235,149558,2012,1413244,3420,1562802,5432,2,1375,10,3571,1418,0
Davidson,47037,12/28/2021,134450,1709,122538,1327,11912,382,147546,1333,1409824,2391,1557370,3724,5,1373,10,3561,1418,3
Davidson,47037,12/27/2021,132741,710,121211,609,11530,101,146213,616,1407433,1175,1553646,1791,8,1368,6,3551,1415,1
Davidson,47037,12/26/2021,132031,176,120602,171,11429,5,145597,184,1406258,465,1551855,649,8,1360,1,3545,1414,2
Davidson,47037,12/25/2021,131855,460,120431,405,11424,55,145413,436,1405793,1087,1551206,1523,0,1352,4,3544,1412,0
Davidson,47037,12/24/2021,131395,972,120026,807,11369,165,144977,1258,1404706,3668,1549683,4926,0,1352,5,3540,1412,4
Davidson,47037,12/23/2021,130423,812,119219,724,11204,88,143719,769,1401038,2496,1544757,3265,6,1352,3,3535,1408,2
Davidson,47037,12/22/2021,129611,942,118495,785,11116,157,142950,823,1398542,2838,1541492,3661,102,1346,4,3532,1406,0
Davidson,47037,12/21/2021,128669,566,117710,499,10959,67,142127,589,1395704,2447,1537831,3036,2,1244,5,3528,1406,1
Davidson,47037,12/20/2021,128103,394,117211,306,10892,88,141538,318,1393257,1674,1534795,1992,3,1242,3,3523,1405,2
Davidson,47037,12/19/2021,127709,193,116905,166,10804,27,141220,182,1391583,1021,1532803,1203,7,1239,1,3520,1403,1
Davidson,47037,12/18/2021,127516,280,116739,234,10777,46,141038,312,1390562,2005,1531600,2317,0,1232,3,3519,1402,3
Davidson,47037,12/17/2021,127236,264,116505,216,10731,48,140726,240,1388557,1924,1529283,2164,2,1232,1,3516,1399,3
Davidson,47037,12/16/2021,126972,319,116289,263,10683,56,140486,306,1386633,2445,1527119,2751,0,1230,2,3515,1396,1
Davidson,47037,12/15/2021,126653,215,116026,178,10627,37,140180,198,1384188,1913,1524368,2111,1,1230,0,3513,1395,0
Davidson,47037,12/14/2021,126438,161,115848,132,10590,29,139982,146,1382275,1467,1522257,1613,5,1229,3,3513,1395,0
Davidson,47037,12/13/2021,126277,127,115716,111,10561,16,139836,124,1380808,1231,1520644,1355,0,1224,3,3510,1395,0
Davidson,47037,12/12/2021,126150,62,115605,51,10545,11,139712,65,1379577,776,1519289,841,2,1224,1,3507,1395,2
Davidson,47037,12/11/2021,126088,113,115554,104,10534,9,139647,142,1378801,1428,1518448,1570,1,1222,6,3506,1393,4
Davidson,47037,12/10/2021,125975,132,115450,114,10525,18,139505,131,1377373,1778,1516878,1909,2,1221,8,3500,1389,0
Davidson,47037,12/9/2021,125843,160,115336,133,10507,27,139374,156,1375595,1575,1514969,1731,-1,1219,6,3492,1389,1
Davidson,47037,12/8/2021,125683,164,115203,126,10480,38,139218,143,1374020,1567,1513238,1710,1,1220,3,3486,1388,2
Davidson,47037,12/7/2021,125519,204,115077,165,10442,39,139075,182,1372453,1862,1511528,2044,2,1219,7,3483,1386,0
Davidson,47037,12/6/2021,125315,133,114912,96,10403,37,138893,123,1370591,1703,1509484,1826,3,1217,3,3476,1386,1
Davidson,47037,12/5/2021,125182,67,114816,64,10366,3,138770,67,1368888,596,1507658,663,9,1214,2,3473,1385,4
Davidson,47037,12/4/2021,125115,135,114752,129,10363,6,138703,157,1368292,1298,1506995,1455,1,1205,5,3471,1381,1
Davidson,47037,12/3/2021,124980,177,114623,150,10357,27,138546,171,1366994,1935,1505540,2106,0,1204,4,3466,1380,2
Davidson,47037,12/2/2021,124803,200,114473,168,10330,32,138375,184,1365059,1773,1503434,1957,5,1204,2,3462,1378,3
Davidson,47037,12/1/2021,124603,176,114305,149,10298,27,138191,161,1363286,2080,1501477,2241,0,1199,2,3460,1375,1
Davidson,47037,11/30/2021,124427,208,114156,175,10271,33,138030,197,1361206,2217,1499236,2414,5,1199,2,3458,1374,2
Davidson,47037,11/29/2021,124219,129,113981,114,10238,15,137833,138,1358989,1555,1496822,1693,2,1194,3,3456,1372,0
Davidson,47037,11/28/2021,124090,45,113867,40,10223,5,137695,50,1357434,734,1495129,784,1,1192,2,3453,1372,2
Davidson,47037,11/27/2021,124045,69,113827,63,10218,6,137645,68,1356700,806,1494345,874,0,1191,1,3451,1370,2
Davidson,47037,11/26/2021,123976,43,113764,42,10212,1,137577,56,1355894,568,1493471,624,0,1191,1,3450,1368,0
Davidson,47037,11/25/2021,123933,72,113722,55,10211,17,137521,66,1355326,877,1492847,943,0,1191,1,3449,1368,1
Davidson,47037,11/24/2021,123861,105,113667,96,10194,9,137455,117,1354449,1831,1491904,1948,1,1191,2,3448,1367,1
Davidson,47037,11/23/2021,123756,167,113571,147,10185,20,137338,177,1352618,2080,1489956,2257,3,1190,5,3446,1366,2
Davidson,47037,11/22/2021,123589,102,113424,86,10165,16,137161,107,1350538,1971,1487699,2078,1,1187,3,3441,1364,0
Davidson,47037,11/21/2021,123487,25,113338,23,10149,2,137054,28,1348567,513,1485621,541,-1,1186,0,3438,1364,1
Davidson,47037,11/20/2021,123462,91,113315,86,10147,5,137026,104,1348054,1231,1485080,1335,0,1187,0,3438,1363,1
Davidson,47037,11/19/2021,123371,147,113229,120,10142,27,136922,141,1346823,1960,1483745,2101,0,1187,1,3438,1362,2
Davidson,47037,11/18/2021,123224,102,113109,82,10115,20,136781,101,1344863,1885,1481644,1986,6,1187,5,3437,1360,1
Davidson,47037,11/17/2021,123122,159,113027,129,10095,30,136680,144,1342978,2299,1479658,2443,0,1181,3,3432,1359,3
Davidson,47037,11/16/2021,122963,137,112898,122,10065,15,136536,142,1340679,1816,1477215,1958,1,1181,2,3429,1356,2
Davidson,47037,11/15/2021,122826,77,112776,65,10050,12,136394,67,1338863,1120,1475257,1187,4,1180,0,3427,1354,0
Davidson,47037,11/14/2021,122749,57,112711,54,10038,3,136327,63,1337743,1022,1474070,1085,2,1176,0,3427,1354,1
Davidson,47037,11/13/2021,122692,81,112657,69,10035,12,136264,79,1336721,1076,1472985,1155,0,1174,2,3427,1353,1
Davidson,47037,11/12/2021,122611,110,112588,81,10023,29,136185,90,1335645,1600,1471830,1690,1,1174,4,3425,1352,4
Davidson,47037,11/11/2021,122501,122,112507,101,9994,21,136095,120,1334045,1799,1470140,1919,0,1173,3,3421,1348,0
Davidson,47037,11/10/2021,122379,118,112406,103,9973,15,135975,106,1332246,1900,1468221,2006,1,1173,5,3418,1348,2
Davidson,47037,11/9/2021,122261,163,112303,126,9958,37,135869,137,1330346,1821,1466215,1958,0,1172,5,3413,1346,2
Davidson,47037,11/8/2021,122098,82,112177,69,9921,13,135732,83,1328525,1523,1464257,1606,1,1172,3,3408,1344,0
Davidson,47037,11/7/2021,122016,49,112108,43,9908,6,135649,53,1327002,776,1462651,829,1,1171,1,3405,1344,0
Davidson,47037,11/6/2021,121967,77,112065,65,9902,12,135596,81,1326226,1156,1461822,1237,0,1170,1,3404,1344,2
Davidson,47037,11/5/2021,121890,81,112000,65,9890,16,135515,75,1325070,1598,1460585,1673,5,1170,0,3403,1342,0
Davidson,47037,11/4/2021,121809,82,111935,71,9874,11,135440,77,1323472,1753,1458912,1830,0,1165,1,3403,1342,2
Davidson,47037,11/3/2021,121727,92,111864,72,9863,20,135363,97,1321719,2042,1457082,2139,1,1165,6,3402,1340,1
Davidson,47037,11/2/2021,121635,110,111792,83,9843,27,135266,97,1319677,1540,1454943,1637,2,1164,1,3396,1339,1
Davidson,47037,11/1/2021,121525,94,111709,78,9816,16,135169,90,1318137,1349,1453306,1439,2,1162,0,3395,1338,2
Davidson,47037,10/31/2021,121431,55,111631,49,9800,6,135079,53,1316788,847,1451867,900,0,1160,4,3395,1336,0
Davidson,47037,10/30/2021,121376,79,111582,73,9794,6,135026,109,1315941,1113,1450967,1222,-1,1160,0,3391,1336,1
Davidson,47037,10/29/2021,121297,92,111509,74,9788,18,134917,98,1314828,1686,1449745,1784,2,1161,1,3391,1335,2
Davidson,47037,10/28/2021,121205,106,111435,86,9770,20,134819,111,1313142,1558,1447961,1669,3,1159,2,3390,1333,1
Davidson,47037,10/27/2021,121099,121,111349,109,9750,12,134708,127,1311584,2246,1446292,2373,1,1156,0,3388,1332,3
Davidson,47037,10/26/2021,120978,118,111240,96,9738,22,134581,118,1309338,1387,1443919,1505,2,1155,4,3388,1329,2
Davidson,47037,10/25/2021,120860,89,111144,67,9716,22,134463,90,1307951,1560,1442414,1650,9,1153,1,3384,1327,0
Davidson,47037,10/24/2021,120771,63,111077,53,9694,10,134373,59,1306391,846,1440764,905,0,1144,3,3383,1327,4
Davidson,47037,10/23/2021,120708,54,111024,47,9684,7,134314,66,1305545,947,1439859,1013,1,1144,2,3380,1323,1
Davidson,47037,10/22/2021,120654,117,110977,98,9677,19,134248,117,1304598,1944,1438846,2061,1,1143,3,3378,1322,4
Davidson,47037,10/21/2021,120537,125,110879,116,9658,9,134131,148,1302654,2002,1436785,2150,1,1142,6,3375,1318,4
Davidson,47037,10/20/2021,120412,123,110763,98,9649,25,133983,115,1300652,1900,1434635,2015,2,1141,5,3369,1314,1
Davidson,47037,10/19/2021,120289,108,110665,89,9624,19,133868,127,1298752,1785,1432620,1912,3,1139,0,3364,1313,1
Davidson,47037,10/18/2021,120181,120,110576,103,9605,17,133741,127,1296967,1760,1430708,1887,8,1136,4,3364,1312,5
Davidson,47037,10/17/2021,120061,32,110473,29,9588,3,133614,38,1295207,582,1428821,620,0,1128,2,3360,1307,1
Davidson,47037,10/16/2021,120029,100,110444,88,9585,12,133576,115,1294625,1048,1428201,1163,0,1128,6,3358,1306,5
Davidson,47037,10/15/2021,119929,153,110356,125,9573,28,133461,161,1293577,1910,1427038,2071,3,1128,6,3352,1301,1
Davidson,47037,10/14/2021,119776,152,110231,130,9545,22,133300,169,1291667,1831,1424967,2000,2,1125,6,3346,1300,3
Davidson,47037,10/13/2021,119624,165,110101,149,9523,16,133131,191,1289836,1832,1422967,2023,0,1123,1,3340,1297,2
Davidson,47037,10/12/2021,119459,213,109952,174,9507,39,132940,221,1288004,1766,1420944,1987,1,1123,6,3339,1295,3
Davidson,47037,10/11/2021,119246,115,109778,81,9468,34,132719,102,1286238,1408,1418957,1510,5,1122,2,3333,1292,4
Davidson,47037,10/10/2021,119131,71,109697,68,9434,3,132617,86,1284830,948,1417447,1034,1,1117,2,3331,1288,1
Davidson,47037,10/9/2021,119060,147,109629,128,9431,19,132531,159,1283882,1408,1416413,1567,0,1116,5,3329,1287,3
Davidson,47037,10/8/2021,118913,195,109501,168,9412,27,132372,221,1282474,2239,1414846,2460,1,1116,13,3324,1284,5
Davidson,47037,10/7/2021,118718,194,109333,165,9385,29,132151,203,1280235,2310,1412386,2513,1,1115,4,3311,1279,2
Davidson,47037,10/6/2021,118524,254,109168,224,9356,30,131948,268,1277925,2483,1409873,2751,1,1114,1,3307,1277,3
Davidson,47037,10/5/2021,118270,262,108944,226,9326,36,131680,261,1275442,2029,1407122,2290,3,1113,9,3306,1274,3
Davidson,47037,10/4/2021,118008,237,108718,185,9290,52,131419,222,1273413,2433,1404832,2655,14,1110,5,3297,1271,3
Davidson,47037,10/3/2021,117771,81,108533,76,9238,5,131197,91,1270980,904,1402177,995,3,1096,0,3292,1268,5
Davidson,47037,10/2/2021,117690,183,108457,163,9233,20,131106,206,1270076,1467,1401182,1673,1,1093,7,3292,1263,2
Davidson,47037,10/1/2021,117507,269,108294,231,9213,38,130900,278,1268609,2582,1399509,2860,0,1092,4,3285,1261,1
Davidson,47037,9/30/2021,117238,319,108063,275,9175,44,130622,342,1266027,2357,1396649,2699,2,1092,6,3281,1260,5
Davidson,47037,9/29/2021,116919,339,107788,309,9131,30,130280,374,1263670,3279,1393950,3653,1,1090,4,3275,1255,7
Davidson,47037,9/28/2021,116580,291,107479,256,9101,35,129906,317,1260391,1905,1390297,2222,3,1089,5,3271,1248,4
Davidson,47037,9/27/2021,116289,254,107223,220,9066,34,129589,290,1258486,2026,1388075,2316,3,1086,1,3266,1244,4
Davidson,47037,9/26/2021,116035,176,107003,152,9032,24,129299,201,1256460,1591,1385759,1792,1,1083,5,3265,1240,0
Davidson,47037,9/25/2021,115859,235,106851,218,9008,17,129098,287,1254869,1492,1383967,1779,1,1082,4,3260,1240,3
Davidson,47037,9/24/2021,115624,316,106633,282,8991,34,128811,335,1253377,2607,1382188,2942,2,1081,9,3256,1237,2
Davidson,47037,9/23/2021,115308,420,106351,376,8957,44,128476,469,1250770,3244,1379246,3713,5,1079,10,3247,1235,7
Davidson,47037,9/22/2021,114888,348,105975,291,8913,57,128007,365,1247526,2149,1375533,2514,1,1074,8,3237,1228,5
Davidson,47037,9/21/2021,114540,321,105684,278,8856,43,127642,361,1245377,2188,1373019,2549,8,1073,11,3229,1223,7
Davidson,47037,9/20/2021,114219,331,105406,287,8813,44,127281,342,1243189,2588,1370470,2930,8,1065,11,3218,1216,5
Davidson,47037,9/19/2021,113888,95,105119,91,8769,4,126939,115,1240601,856,1367540,971,1,1057,11,3207,1211,3
Davidson,47037,9/18/2021,113793,358,105028,325,8765,33,126824,409,1239745,2681,1366569,3090,0,1056,8,3196,1208,6
Davidson,47037,9/17/2021,113435,500,104703,434,8732,66,126415,542,1237064,3541,1363479,4083,3,1056,13,3188,1202,6
Davidson,47037,9/16/2021,112935,383,104269,344,8666,39,125873,403,1233523,2429,1359396,2832,4,1053,5,3175,1196,6
Davidson,47037,9/15/2021,112552,288,103925,260,8627,28,125470,319,1231094,1649,1356564,1968,5,1049,14,3170,1190,3
Davidson,47037,9/14/2021,112264,588,103665,517,8599,71,125151,638,1229445,3305,1354596,3943,5,1044,10,3156,1187,8
Davidson,47037,9/13/2021,111676,317,103148,279,8528,38,124513,323,1226140,2174,1350653,2497,6,1039,15,3146,1179,8
Davidson,47037,9/12/2021,111359,227,102869,203,8490,24,124190,231,1223966,1250,1348156,1481,2,1033,7,3131,1171,0
Davidson,47037,9/11/2021,111132,784,102666,718,8466,66,123959,842,1222716,4676,1346675,5518,0,1031,20,3124,1171,6
Davidson,47037,9/10/2021,110348,1177,101948,1046,8400,131,123117,1193,1218040,6294,1341157,7487,6,1031,18,3104,1165,7
Davidson,47037,9/9/2021,109171,439,100902,410,8269,29,121924,467,1211746,2404,1333670,2871,0,1025,7,3086,1158,2
Davidson,47037,9/8/2021,108732,312,100492,280,8240,32,121457,313,1209342,1573,1330799,1886,2,1025,7,3079,1156,6
Davidson,47037,9/7/2021,108420,292,100212,272,8208,20,121144,308,1207769,1386,1328913,1694,6,1023,6,3072,1150,5
Davidson,47037,9/6/2021,108128,856,99940,758,8188,98,120836,916,1206383,5530,1327219,6446,2,1017,11,3066,1145,4
Davidson,47037,9/5/2021,107272,910,99182,819,8090,91,119920,929,1200853,5215,1320773,6144,1,1015,5,3055,1141,3
Davidson,47037,9/4/2021,106362,672,98363,601,7999,71,118991,678,1195638,3927,1314629,4605,2,1014,7,3050,1138,7
Davidson,47037,9/3/2021,105690,193,97762,170,7928,23,118313,205,1191711,1156,1310024,1361,5,1012,2,3043,1131,7
Davidson,47037,9/2/2021,105497,600,97592,535,7905,65,118108,611,1190555,3110,1308663,3721,5,1007,13,3041,1124,5
Davidson,47037,9/1/2021,104897,115,97057,86,7840,29,117497,95,1187445,558,1304942,653,0,1002,2,3028,1119,4
Davidson,47037,8/31/2021,104782,549,96971,475,7811,74,117402,537,1186887,3359,1304289,3896,0,1002,17,3026,1115,4
Davidson,47037,8/30/2021,104233,676,96496,634,7737,42,116865,762,1183528,3919,1300393,4681,4,1002,15,3009,1111,3
Davidson,47037,8/29/2021,103557,446,95862,400,7695,46,116103,469,1179609,2608,1295712,3077,0,998,7,2994,1108,3
Davidson,47037,8/28/2021,103111,404,95462,364,7649,40,115634,424,1177001,2385,1292635,2809,0,998,6,2987,1105,1
Davidson,47037,8/27/2021,102707,494,95098,436,7609,58,115210,482,1174616,2486,1289826,2968,3,998,11,2981,1104,2
Davidson,47037,8/26/2021,102213,450,94662,397,7551,53,114728,463,1172130,3005,1286858,3468,0,995,7,2970,1102,2
Davidson,47037,8/25/2021,101763,473,94265,425,7498,48,114265,465,1169125,2092,1283390,2557,4,995,9,2963,1100,4
Davidson,47037,8/24/2021,101290,266,93840,237,7450,29,113800,273,1167033,1649,1280833,1922,0,991,4,2954,1096,4
Davidson,47037,8/23/2021,101024,252,93603,208,7421,44,113527,231,1165384,1057,1278911,1288,1,991,12,2950,1092,1
Davidson,47037,8/22/2021,100772,287,93395,278,7377,9,113296,313,1164327,1999,1277623,2312,6,990,3,2938,1091,2
Davidson,47037,8/21/2021,100485,706,93117,646,7368,60,112983,725,1162328,4134,1275311,4859,0,984,3,2935,1089,4
Davidson,47037,8/20/2021,99779,362,92471,312,7308,50,112258,350,1158194,2537,1270452,2887,0,984,5,2932,1085,1
Davidson,47037,8/19/2021,99417,313,92159,261,7258,52,111908,304,1155657,2269,1267565,2573,2,984,5,2927,1084,1
Davidson,47037,8/18/2021,99104,506,91898,451,7206,55,111604,518,1153388,2979,1264992,3497,2,982,4,2922,1083,1
Davidson,47037,8/17/2021,98598,521,91447,464,7151,57,111086,538,1150409,2549,1261495,3087,0,980,6,2918,1082,4
Davidson,47037,8/16/2021,98077,205,90983,182,7094,23,110548,221,1147860,1218,1258408,1439,0,980,1,2912,1078,1
Davidson,47037,8/15/2021,97872,156,90801,143,7071,13,110327,166,1146642,1029,1256969,1195,4,980,1,2911,1077,1
Davidson,47037,8/14/2021,97716,395,90658,365,7058,30,110161,427,1145613,2553,1255774,2980,0,976,4,2910,1076,4
Davidson,47037,8/13/2021,97321,490,90293,432,7028,58,109734,489,1143060,2795,1252794,3284,0,976,6,2906,1072,5
Davidson,47037,8/12/2021,96831,354,89861,323,6970,31,109245,373,1140265,1971,1249510,2344,0,976,8,2900,1067,0
Davidson,47037,8/11/2021,96477,503,89538,462,6939,41,108872,515,1138294,2961,1247166,3476,1,976,6,2892,1067,3
Davidson,47037,8/10/2021,95974,321,89076,276,6898,45,108357,328,1135333,2038,1243690,2366,0,975,7,2886,1064,2
Davidson,47037,8/9/2021,95653,228,88800,196,6853,32,108029,212,1133295,1230,1241324,1442,7,975,9,2879,1062,3
Davidson,47037,8/8/2021,95425,194,88604,177,6821,17,107817,209,1132065,1273,1239882,1482,0,968,6,2870,1059,1
Davidson,47037,8/7/2021,95231,237,88427,226,6804,11,107608,271,1130792,1625,1238400,1896,0,968,5,2864,1058,0
Davidson,47037,8/6/2021,94994,377,88201,325,6793,52,107337,360,1129167,2485,1236504,2845,0,968,8,2859,1058,3
Davidson,47037,8/5/2021,94617,420,87876,365,6741,55,106977,413,1126682,2469,1233659,2882,3,968,9,2851,1055,1
Davidson,47037,8/4/2021,94197,267,87511,241,6686,26,106564,283,1124213,1741,1230777,2024,3,965,9,2842,1054,0
Davidson,47037,8/3/2021,93930,363,87270,313,6660,50,106281,349,1122472,2199,1228753,2548,2,962,14,2833,1054,2
Davidson,47037,8/2/2021,93567,296,86957,261,6610,35,105932,296,1120273,1648,1226205,1944,0,960,6,2819,1052,3
Davidson,47037,8/1/2021,93271,146,86696,138,6575,8,105636,151,1118625,1260,1224261,1411,2,960,5,2813,1049,0
Davidson,47037,7/31/2021,93125,183,86558,165,6567,18,105485,197,1117365,1286,1222850,1483,0,958,4,2808,1049,1
Davidson,47037,7/30/2021,92942,302,86393,274,6549,28,105288,314,1116079,1310,1221367,1624,1,958,6,2804,1048,1
Davidson,47037,7/29/2021,92640,199,86119,177,6521,22,104974,205,1114769,1620,1219743,1825,-1,957,5,2798,1047,1
Davidson,47037,7/28/2021,92441,201,85942,178,6499,23,104769,196,1113149,1785,1217918,1981,0,958,6,2793,1046,1
Davidson,47037,7/27/2021,92240,196,85764,148,6476,48,104573,166,1111364,1361,1215937,1527,3,958,9,2787,1045,1
Davidson,47037,7/26/2021,92044,211,85616,197,6428,14,104407,216,1110003,1387,1214410,1603,0,955,6,2778,1044,1
Davidson,47037,7/25/2021,91833,76,85419,67,6414,9,104191,75,1108616,614,1212807,689,0,955,2,2772,1043,1
Davidson,47037,7/24/2021,91757,123,85352,105,6405,18,104116,138,1108002,904,1212118,1042,0,955,6,2770,1042,0
Davidson,47037,7/23/2021,91634,137,85247,110,6387,27,103978,118,1107098,1233,1211076,1351,0,955,0,2764,1042,2
Davidson,47037,7/22/2021,91497,129,85137,110,6360,19,103860,124,1105865,1298,1209725,1422,0,955,4,2764,1040,1
Davidson,47037,7/21/2021,91368,144,85027,119,6341,25,103736,124,1104567,1107,1208303,1231,1,955,6,2760,1039,0
Davidson,47037,7/20/2021,91224,156,84908,135,6316,21,103612,152,1103460,1611,1207072,1763,0,954,8,2754,1039,0
Davidson,47037,7/19/2021,91068,77,84773,65,6295,12,103460,74,1101849,903,1205309,977,1,954,4,2746,1039,1
Davidson,47037,7/18/2021,90991,28,84708,23,6283,5,103386,25,1100946,511,1204332,536,0,953,1,2742,1038,0
Davidson,47037,7/17/2021,90963,58,84685,49,6278,9,103361,55,1100435,731,1203796,786,0,953,1,2741,1038,1
Davidson,47037,7/16/2021,90905,61,84636,56,6269,5,103306,61,1099704,1004,1203010,1065,2,953,4,2740,1037,1
Davidson,47037,7/15/2021,90844,80,84580,67,6264,13,103245,79,1098700,1161,1201945,1240,0,951,1,2736,1036,0
Davidson,47037,7/14/2021,90764,67,84513,56,6251,11,103166,60,1097539,1059,1200705,1119,2,951,2,2735,1036,0
Davidson,47037,7/13/2021,90697,92,84457,73,6240,19,103106,74,1096480,1115,1199586,1189,0,949,6,2733,1036,0
Davidson,47037,7/12/2021,90605,47,84384,41,6221,6,103032,49,1095365,688,1198397,737,0,949,1,2727,1036,0
Davidson,47037,7/11/2021,90558,16,84343,14,6215,2,102983,18,1094677,391,1197660,409,0,949,3,2726,1036,0
Davidson,47037,7/10/2021,90542,36,84329,26,6213,10,102965,27,1094286,547,1197251,574,0,949,2,2723,1036,0
Davidson,47037,7/9/2021,90506,65,84303,54,6203,11,102938,52,1093739,975,1196677,1027,0,949,3,2721,1036,0
Davidson,47037,7/8/2021,90441,57,84249,45,6192,12,102886,49,1092764,962,1195650,1011,0,949,2,2718,1036,0
Davidson,47037,7/7/2021,90384,76,84204,62,6180,14,102837,66,1091802,965,1194639,1031,1,949,3,2716,1036,0
Davidson,47037,7/6/2021,90308,36,84142,29,6166,7,102771,35,1090837,754,1193608,789,0,948,0,2713,1036,0
Davidson,47037,7/5/2021,90272,19,84113,15,6159,4,102736,15,1090083,278,1192819,293,0,948,1,2713,1036,0
Davidson,47037,7/4/2021,90253,19,84098,16,6155,3,102721,17,1089805,399,1192526,416,0,948,1,2712,1036,0
Davidson,47037,7/3/2021,90234,23,84082,16,6152,7,102704,20,1089406,474,1192110,494,0,948,3,2711,1036,0
Davidson,47037,7/2/2021,90211,20,84066,16,6145,4,102684,21,1088932,818,1191616,839,1,948,0,2708,1036,0
Davidson,47037,7/1/2021,90191,28,84050,16,6141,12,102663,19,1088114,872,1190777,891,0,947,0,2708,1036,1
Davidson,47037,6/30/2021,90163,29,84034,23,6129,6,102644,29,1087242,875,1189886,904,0,947,2,2708,1035,0
Davidson,47037,6/29/2021,90134,37,84011,27,6123,10,102615,29,1086367,1157,1188982,1186,0,947,1,2706,1035,0
Davidson,47037,6/28/2021,90097,9,83984,8,6113,1,102586,10,1085210,623,1187796,633,0,947,0,2705,1035,0
Davidson,47037,6/27/2021,90088,7,83976,5,6112,2,102576,7,1084587,409,1187163,416,1,947,0,2705,1035,0
Davidson,47037,6/26/2021,90081,11,83971,10,6110,1,102569,11,1084178,544,1186747,555,1,946,0,2705,1035,0
Davidson,47037,6/25/2021,90070,13,83961,12,6109,1,102558,19,1083634,852,1186192,871,0,945,0,2705,1035,1
Davidson,47037,6/24/2021,90057,21,83949,17,6108,4,102539,24,1082782,900,1185321,924,1,945,2,2705,1034,1
Davidson,47037,6/23/2021,90036,24,83932,19,6104,5,102515,26,1081882,1050,1184397,1076,1,944,1,2703,1033,0
Davidson,47037,6/22/2021,90012,18,83913,12,6099,6,102489,17,1080832,819,1183321,836,-1,943,1,2702,1033,1
Davidson,47037,6/21/2021,89994,15,83901,15,6093,0,102472,25,1080013,839,1182485,864,0,944,0,2701,1032,0
Davidson,47037,6/20/2021,89979,14,83886,12,6093,2,102447,13,1079174,409,1181621,422,0,944,1,2701,1032,0
Davidson,47037,6/19/2021,89965,11,83874,7,6091,4,102434,8,1078765,593,1181199,601,0,944,0,2700,1032,0
Davidson,47037,6/18/2021,89954,13,83867,11,6087,2,102426,18,1078172,878,1180598,896,0,944,1,2700,1032,0
Davidson,47037,6/17/2021,89941,24,83856,21,6085,3,102408,28,1077294,1168,1179702,1196,1,944,0,2699,1032,0
Davidson,47037,6/16/2021,89917,18,83835,14,6082,4,102380,19,1076126,1101,1178506,1120,1,943,1,2699,1032,1
Davidson,47037,6/15/2021,89899,26,83821,19,6078,7,102361,21,1075025,888,1177386,909,0,942,0,2698,1031,0
Davidson,47037,6/14/2021,89873,26,83802,20,6071,6,102340,30,1074137,1118,1176477,1148,0,942,3,2698,1031,0
Davidson,47037,6/13/2021,89847,8,83782,6,6065,2,102310,11,1073019,421,1175329,432,-1,942,0,2695,1031,0
Davidson,47037,6/12/2021,89839,13,83776,7,6063,6,102299,8,1072598,554,1174897,562,-4,943,3,2695,1031,1
Davidson,47037,6/11/2021,89826,18,83769,10,6057,8,102291,10,1072044,948,1174335,958,-9,947,2,2692,1030,1
Davidson,47037,6/10/2021,89808,20,83759,16,6049,4,102281,16,1071096,1154,1173377,1170,7,956,1,2690,1029,0
Davidson,47037,6/9/2021,89788,24,83743,19,6045,5,102265,27,1069942,1118,1172207,1145,0,949,1,2689,1029,0
Davidson,47037,6/8/2021,89764,26,83724,23,6040,3,102238,29,1068824,1068,1171062,1097,-1,949,1,2688,1029,1
Davidson,47037,6/7/2021,89738,27,83701,22,6037,5,102209,21,1067756,807,1169965,828,2,950,1,2687,1028,0
Davidson,47037,6/6/2021,89711,11,83679,8,6032,3,102188,9,1066949,544,1169137,553,0,948,3,2686,1028,1
Davidson,47037,6/5/2021,89700,18,83671,12,6029,6,102179,15,1066405,692,1168584,707,0,948,1,2683,1027,0
Davidson,47037,6/4/2021,89682,21,83659,10,6023,11,102164,13,1065713,1321,1167877,1334,0,948,0,2682,1027,1
Davidson,47037,6/3/2021,89661,41,83649,36,6012,5,102151,42,1064392,1443,1166543,1485,0,948,4,2682,1026,1
Davidson,47037,6/2/2021,89620,35,83613,30,6007,5,102109,34,1062949,1080,1165058,1114,0,948,4,2678,1025,1
Davidson,47037,6/1/2021,89585,58,83583,39,6002,19,102075,41,1061869,1046,1163944,1087,1,948,0,2674,1024,0
Davidson,47037,5/31/2021,89527,16,83544,11,5983,5,102034,15,1060823,373,1162857,388,1,947,2,2674,1024,0
Davidson,47037,5/30/2021,89511,10,83533,9,5978,1,102019,11,1060450,531,1162469,542,0,946,1,2672,1024,2
Davidson,47037,5/29/2021,89501,26,83524,20,5977,6,102008,30,1059919,717,1161927,747,0,946,1,2671,1022,0
Davidson,47037,5/28/2021,89475,31,83504,26,5971,5,101978,31,1059202,1247,1161180,1278,1,946,0,2670,1022,1
Davidson,47037,5/27/2021,89444,38,83478,27,5966,11,101947,38,1057955,1374,1159902,1412,1,945,1,2670,1021,1
Davidson,47037,5/26/2021,89406,32,83451,26,5955,6,101909,31,1056581,1416,1158490,1447,0,944,3,2669,1020,1
Davidson,47037,5/25/2021,89374,30,83425,22,5949,8,101878,25,1055165,1411,1157043,1436,0,944,0,2666,1019,1
Davidson,47037,5/24/2021,89344,34,83403,31,5941,3,101853,33,1053754,1322,1155607,1355,1,944,2,2666,1018,0
Davidson,47037,5/23/2021,89310,17,83372,15,5938,2,101820,19,1052432,869,1154252,888,1,943,1,2664,1018,1
Davidson,47037,5/22/2021,89293,26,83357,20,5936,6,101801,28,1051563,836,1153364,864,0,942,1,2663,1017,2
Davidson,47037,5/21/2021,89267,45,83337,33,5930,12,101773,34,1050727,1311,1152500,1345,0,942,0,2662,1015,1
Davidson,47037,5/20/2021,89222,48,83304,39,5918,9,101739,50,1049416,1637,1151155,1687,0,942,3,2662,1014,0
Davidson,47037,5/19/2021,89174,46,83265,38,5909,8,101689,50,1047779,1584,1149468,1634,1,942,3,2659,1014,1
Davidson,47037,5/18/2021,89128,53,83227,46,5901,7,101639,53,1046195,1448,1147834,1501,1,941,1,2656,1013,1
Davidson,47037,5/17/2021,89075,63,83181,55,5894,8,101586,65,1044747,1511,1146333,1576,2,940,4,2655,1012,0
Davidson,47037,5/16/2021,89012,17,83126,13,5886,4,101521,19,1043236,603,1144757,622,0,938,1,2651,1012,1
Davidson,47037,5/15/2021,88995,57,83113,51,5882,6,101502,61,1042633,1022,1144135,1083,0,938,3,2650,1011,0
Davidson,47037,5/14/2021,88938,58,83062,50,5876,8,101441,62,1041611,1496,1143052,1558,0,938,2,2647,1011,1
Davidson,47037,5/13/2021,88880,67,83012,50,5868,17,101379,51,1040115,1366,1141494,1417,1,938,4,2645,1010,0
Davidson,47037,5/12/2021,88813,50,82962,40,5851,10,101328,51,1038749,2012,1140077,2063,1,937,1,2641,1010,3
Davidson,47037,5/11/2021,88763,87,82922,70,5841,17,101277,79,1036737,1390,1138014,1469,0,936,7,2640,1007,1
Davidson,47037,5/10/2021,88676,40,82852,32,5824,8,101198,50,1035347,1297,1136545,1347,2,936,4,2633,1006,1
Davidson,47037,5/9/2021,88636,19,82820,15,5816,4,101148,21,1034050,1403,1135198,1424,4,934,2,2629,1005,1
Davidson,47037,5/8/2021,88617,53,82805,45,5812,8,101127,65,1032647,1800,1133774,1865,0,930,1,2627,1004,0
Davidson,47037,5/7/2021,88564,78,82760,67,5804,11,101062,86,1030847,2245,1131909,2331,1,930,5,2626,1004,2
Davidson,47037,5/6/2021,88486,54,82693,41,5793,13,100976,53,1028602,1410,1129578,1463,0,929,3,2621,1002,1
Davidson,47037,5/5/2021,88432,58,82652,42,5780,16,100923,56,1027192,2233,1128115,2289,1,929,4,2618,1001,0
Davidson,47037,5/4/2021,88374,72,82610,57,5764,15,100867,68,1024959,1925,1125826,1993,0,928,1,2614,1001,0
Davidson,47037,5/3/2021,88302,55,82553,38,5749,17,100799,58,1023034,1411,1123833,1469,1,928,1,2613,1001,2
Davidson,47037,5/2/2021,88247,57,82515,47,5732,10,100741,55,1021623,1541,1122364,1596,0,927,3,2612,999,0
Davidson,47037,5/1/2021,88190,53,82468,43,5722,10,100686,51,1020082,1809,1120768,1860,0,927,0,2609,999,2
Davidson,47037,4/30/2021,88137,114,82425,95,5712,19,100635,121,1018273,2030,1118908,2151,0,927,1,2609,997,2
Davidson,47037,4/29/2021,88023,72,82330,49,5693,23,100514,59,1016243,2168,1116757,2227,0,927,3,2608,995,0
Davidson,47037,4/28/2021,87951,84,82281,68,5670,16,100455,82,1014075,4417,1114530,4499,2,927,2,2605,995,1
Davidson,47037,4/27/2021,87867,93,82213,73,5654,20,100373,94,1009658,2155,1110031,2249,0,925,6,2603,994,1
Davidson,47037,4/26/2021,87774,97,82140,83,5634,14,100279,95,1007503,1514,1107782,1609,0,925,3,2597,993,1
Davidson,47037,4/25/2021,87677,54,82057,45,5620,9,100184,56,1005989,1736,1106173,1792,1,925,0,2594,992,0
Davidson,47037,4/24/2021,87623,65,82012,59,5611,6,100128,72,1004253,2605,1104381,2677,0,924,6,2594,992,1
Davidson,47037,4/23/2021,87558,91,81953,77,5605,14,100056,97,1001648,1689,1101704,1786,-1,924,3,2588,991,1
Davidson,47037,4/22/2021,87467,119,81876,92,5591,27,99959,113,999959,4646,1099918,4759,2,925,3,2585,990,1
Davidson,47037,4/21/2021,87348,125,81784,106,5564,19,99846,123,995313,2031,1095159,2154,1,923,5,2582,989,1
Davidson,47037,4/20/2021,87223,147,81678,143,5545,4,99723,167,993282,2413,1093005,2580,2,922,2,2577,988,2
Davidson,47037,4/19/2021,87076,71,81535,55,5541,16,99556,62,990869,2196,1090425,2258,0,920,6,2575,986,0
Davidson,47037,4/18/2021,87005,69,81480,55,5525,14,99494,62,988673,1946,1088167,2008,1,920,2,2569,986,0
Davidson,47037,4/17/2021,86936,89,81425,78,5511,11,99432,95,986727,2509,1086159,2604,0,919,2,2567,986,0
Davidson,47037,4/16/2021,86847,563,81347,551,5500,12,99337,660,984218,4206,1083555,4866,0,919,1,2565,986,1
Davidson,47037,4/15/2021,86284,120,80796,104,5488,16,98677,111,980012,4474,1078689,4585,-1,919,2,2564,985,1
Davidson,47037,4/14/2021,86164,132,80692,110,5472,22,98566,137,975538,4594,1074104,4731,2,920,3,2562,984,2
Davidson,47037,4/13/2021,86032,104,80582,84,5450,20,98429,109,970944,1472,1069373,1581,3,918,9,2559,982,2
Davidson,47037,4/12/2021,85928,141,80498,124,5430,17,98320,149,969472,1528,1067792,1677,0,915,4,2550,980,4
Davidson,47037,4/11/2021,85787,61,80374,49,5413,12,98171,61,967944,1572,1066115,1633,0,915,2,2546,976,1
Davidson,47037,4/10/2021,85726,73,80325,56,5401,17,98110,69,966372,2377,1064482,2446,1,915,8,2544,975,1
Davidson,47037,4/9/2021,85653,146,80269,119,5384,27,98041,137,963995,2519,1062036,2656,0,914,4,2536,974,1
Davidson,47037,4/8/2021,85507,110,80150,97,5357,13,97904,127,961476,2163,1059380,2290,1,914,4,2532,973,0
Davidson,47037,4/7/2021,85397,113,80053,103,5344,10,97777,121,959313,2862,1057090,2983,1,913,6,2528,973,4
Davidson,47037,4/6/2021,85284,192,79950,163,5334,29,97656,192,956451,3415,1054107,3607,1,912,6,2522,969,1
Davidson,47037,4/5/2021,85092,68,79787,54,5305,14,97464,62,953036,728,1050500,790,8,911,5,2516,968,0
Davidson,47037,4/4/2021,85024,77,79733,63,5291,14,97402,76,952308,3548,1049710,3624,1,903,5,2511,968,2
Davidson,47037,4/3/2021,84947,111,79670,92,5277,19,97326,104,948760,2341,1046086,2445,0,902,3,2506,966,1
Davidson,47037,4/2/2021,84836,112,79578,101,5258,11,97222,134,946419,1951,1043641,2085,1,902,2,2503,965,2
Davidson,47037,4/1/2021,84724,118,79477,108,5247,10,97088,137,944468,2183,1041556,2320,3,901,2,2501,963,3
Davidson,47037,3/31/2021,84606,183,79369,141,5237,42,96951,167,942285,4161,1039236,4328,6,898,3,2499,960,2
Davidson,47037,3/30/2021,84423,163,79228,154,5195,9,96784,186,938124,3221,1034908,3407,0,892,5,2496,958,3
Davidson,47037,3/29/2021,84260,74,79074,50,5186,24,96598,65,934903,1196,1031501,1261,2,892,2,2491,955,3
Davidson,47037,3/28/2021,84186,99,79024,72,5162,27,96533,85,933707,3709,1030240,3794,2,890,4,2489,952,1
Davidson,47037,3/27/2021,84087,130,78952,128,5135,2,96448,157,929998,2340,1026446,2497,0,888,4,2485,951,1
Davidson,47037,3/26/2021,83957,103,78824,85,5133,18,96291,100,927658,1328,1023949,1428,2,888,5,2481,950,5
Davidson,47037,3/25/2021,83854,164,78739,135,5115,29,96191,151,926330,2833,1022521,2984,2,886,2,2476,945,3
Davidson,47037,3/24/2021,83690,171,78604,147,5086,24,96040,165,923497,3517,1019537,3682,1,884,4,2474,942,1
Davidson,47037,3/23/2021,83519,115,78457,103,5062,12,95875,137,919980,2834,1015855,2971,3,883,3,2470,941,0
Davidson,47037,3/22/2021,83404,138,78354,112,5050,26,95738,126,917146,1317,1012884,1443,4,880,5,2467,941,2
Davidson,47037,3/21/2021,83266,81,78242,61,5024,20,95612,71,915829,2074,1011441,2145,-4,876,3,2462,939,1
Davidson,47037,3/20/2021,83185,91,78181,73,5004,18,95541,90,913755,1284,1009296,1374,-1,880,1,2459,938,0
Davidson,47037,3/19/2021,83094,207,78108,153,4986,54,95451,181,912471,3903,1007922,4084,4,881,3,2458,938,3
Davidson,47037,3/18/2021,82887,142,77955,114,4932,28,95270,141,908568,3330,1003838,3471,3,877,3,2455,935,1
Davidson,47037,3/17/2021,82745,126,77841,111,4904,15,95129,143,905238,1902,1000367,2045,2,874,3,2452,934,0
Davidson,47037,3/16/2021,82619,248,77730,202,4889,46,94986,242,903336,4040,998322,4282,0,872,7,2449,934,3
Davidson,47037,3/15/2021,82371,92,77528,72,4843,20,94744,74,899296,1190,994040,1264,1,872,5,2442,931,2
Davidson,47037,3/14/2021,82279,62,77456,48,4823,14,94670,56,898106,1774,992776,1830,0,871,3,2437,929,3
Davidson,47037,3/13/2021,82217,220,77408,121,4809,99,94614,147,896332,2838,990946,2985,-12,871,3,2434,926,1
Davidson,47037,3/12/2021,81997,128,77287,107,4710,21,94467,117,893494,2607,987961,2724,0,883,6,2431,925,3
Davidson,47037,3/11/2021,81869,158,77180,132,4689,26,94350,153,890887,4673,985237,4826,2,883,4,2425,922,0
Davidson,47037,3/10/2021,81711,150,77048,124,4663,26,94197,149,886214,3910,980411,4059,0,881,6,2421,922,4
Davidson,47037,3/9/2021,81561,156,76924,129,4637,27,94048,156,882304,3759,976352,3915,3,881,6,2415,918,1
Davidson,47037,3/8/2021,81405,121,76795,95,4610,26,93892,106,878545,1960,972437,2066,4,878,3,2409,917,4
Davidson,47037,3/7/2021,81284,74,76700,46,4584,28,93786,57,876585,802,970371,859,0,874,2,2406,913,2
Davidson,47037,3/6/2021,81210,157,76654,118,4556,39,93729,145,875783,3557,969512,3702,1,874,5,2404,911,1
Davidson,47037,3/5/2021,81053,114,76536,87,4517,27,93584,110,872226,1680,965810,1790,2,873,2,2399,910,1
Davidson,47037,3/4/2021,80939,137,76449,110,4490,27,93474,136,870546,5397,964020,5533,1,871,4,2397,909,4
Davidson,47037,3/3/2021,80802,140,76339,113,4463,27,93338,138,865149,2432,958487,2570,1,870,2,2393,905,3
Davidson,47037,3/2/2021,80662,167,76226,134,4436,33,93200,170,862717,2900,955917,3070,2,869,1,2391,902,1
Davidson,47037,3/1/2021,80495,48,76092,34,4403,14,93030,44,859817,763,952847,807,6,867,4,2390,901,1
Davidson,47037,2/28/2021,80447,62,76058,47,4389,15,92986,64,859054,3011,952040,3075,4,861,1,2386,900,1
Davidson,47037,2/27/2021,80385,157,76011,127,4374,30,92922,146,856043,3332,948965,3478,3,857,3,2385,899,4
Davidson,47037,2/26/2021,80228,105,75884,81,4344,24,92776,108,852711,1573,945487,1681,5,854,0,2382,895,5
Davidson,47037,2/25/2021,80123,173,75803,131,4320,42,92668,161,851138,3664,943806,3825,8,849,8,2382,890,4
Davidson,47037,2/24/2021,79950,254,75672,235,4278,19,92507,292,847474,4778,939981,5070,6,841,7,2374,886,5
Davidson,47037,2/23/2021,79696,206,75437,147,4259,59,92215,172,842696,3294,934911,3466,2,835,8,2367,881,1
Davidson,47037,2/22/2021,79490,88,75290,65,4200,23,92043,76,839402,1006,931445,1082,3,833,5,2359,880,3
Davidson,47037,2/21/2021,79402,103,75225,77,4177,26,91967,91,838396,765,930363,856,1,830,1,2354,877,2
Davidson,47037,2/20/2021,79299,98,75148,63,4151,35,91876,76,837631,871,929507,947,6,829,3,2353,875,2
Davidson,47037,2/19/2021,79201,97,75085,78,4116,19,91800,93,836760,479,928560,572,0,823,8,2350,873,3
Davidson,47037,2/18/2021,79104,150,75007,118,4097,32,91707,134,836281,1052,927988,1186,7,823,3,2342,870,5
Davidson,47037,2/17/2021,78954,35,74889,24,4065,11,91573,26,835229,382,926802,408,2,816,1,2339,865,4
Davidson,47037,2/16/2021,78919,86,74865,76,4054,10,91547,83,834847,1756,926394,1839,3,814,1,2338,861,3
Davidson,47037,2/15/2021,78833,69,74789,52,4044,17,91464,63,833091,1307,924555,1370,2,811,1,2337,858,2
Davidson,47037,2/14/2021,78764,114,74737,85,4027,29,91401,94,831784,3265,923185,3359,1,809,2,2336,856,4
Davidson,47037,2/13/2021,78650,173,74652,144,3998,29,91307,188,828519,2379,919826,2567,2,808,7,2334,852,6
Davidson,47037,2/12/2021,78477,185,74508,156,3969,29,91119,182,826140,4734,917259,4916,2,806,7,2327,846,1
Davidson,47037,2/11/2021,78292,267,74352,233,3940,34,90937,271,821406,2910,912343,3181,6,804,5,2320,845,1
Davidson,47037,2/10/2021,78025,222,74119,192,3906,30,90666,230,818496,3554,909162,3784,-2,798,5,2315,844,1
Davidson,47037,2/9/2021,77803,333,73927,301,3876,32,90436,369,814942,4206,905378,4575,2,800,7,2310,843,2
Davidson,47037,2/8/2021,77470,92,73626,71,3844,21,90067,88,810736,711,900803,799,8,798,5,2303,841,2
Davidson,47037,2/7/2021,77378,111,73555,81,3823,30,89979,85,810025,2590,900004,2675,2,790,4,2298,839,1
Davidson,47037,2/6/2021,77267,396,73474,343,3793,53,89894,430,807435,6412,897329,6842,0,788,12,2294,838,3
Davidson,47037,2/5/2021,76871,191,73131,162,3740,29,89464,179,801023,3729,890487,3908,17,788,2,2282,835,8
Davidson,47037,2/4/2021,76680,251,72969,217,3711,34,89285,266,797294,4934,886579,5200,12,771,7,2280,827,4
Davidson,47037,2/3/2021,76429,391,72752,339,3677,52,89019,428,792360,5019,881379,5447,7,759,5,2273,823,3
Davidson,47037,2/2/2021,76038,87,72413,68,3625,19,88591,85,787341,913,875932,998,10,752,1,2268,820,8
Davidson,47037,2/1/2021,75951,125,72345,88,3606,37,88506,99,786428,1436,874934,1535,11,742,3,2267,812,2
Davidson,47037,1/31/2021,75826,167,72257,127,3569,40,88407,152,784992,1733,873399,1885,3,731,1,2264,810,1
Davidson,47037,1/30/2021,75659,433,72130,401,3529,32,88255,525,783259,6245,871514,6770,2,728,3,2263,809,6
Davidson,47037,1/29/2021,75226,222,71729,195,3497,27,87730,246,777014,2035,864744,2281,3,726,4,2260,803,4
Davidson,47037,1/28/2021,75004,177,71534,126,3470,51,87484,136,774979,2184,862463,2320,4,723,2,2256,799,4
Davidson,47037,1/27/2021,74827,305,71408,279,3419,26,87348,357,772795,2527,860143,2884,3,719,2,2254,795,5
Davidson,47037,1/26/2021,74522,459,71129,411,3393,48,86991,503,770268,4256,857259,4759,19,716,4,2252,790,4
Davidson,47037,1/25/2021,74063,162,70718,127,3345,35,86488,146,766012,3812,852500,3958,4,697,3,2248,786,6
Davidson,47037,1/24/2021,73901,161,70591,138,3310,23,86342,167,762200,1322,848542,1489,1,693,1,2245,780,6
Davidson,47037,1/23/2021,73740,431,70453,365,3287,66,86175,501,760878,4284,847053,4785,4,692,6,2244,774,7
Davidson,47037,1/22/2021,73309,305,70088,275,3221,30,85674,321,756594,2655,842268,2976,9,688,3,2238,767,1
Davidson,47037,1/21/2021,73004,444,69813,401,3191,43,85353,499,753939,3960,839292,4459,1,679,8,2235,766,8
Davidson,47037,1/20/2021,72560,469,69412,402,3148,67,84854,527,749979,3014,834833,3541,6,678,2,2227,758,5
Davidson,47037,1/19/2021,72091,427,69010,366,3081,61,84327,415,746965,3145,831292,3560,7,672,12,2225,753,9
Davidson,47037,1/18/2021,71664,167,68644,141,3020,26,83912,159,743820,994,827732,1153,4,665,2,2213,744,9
Davidson,47037,1/17/2021,71497,262,68503,239,2994,23,83753,270,742826,1737,826579,2007,5,661,3,2211,735,8
Davidson,47037,1/16/2021,71235,830,68264,766,2971,64,83483,987,741089,5416,824572,6403,2,656,9,2208,727,4
Davidson,47037,1/15/2021,70405,259,67498,226,2907,33,82496,286,735673,2415,818169,2701,6,654,1,2199,723,7
Davidson,47037,1/14/2021,70146,633,67272,571,2874,62,82210,669,733258,3759,815468,4428,2,648,5,2198,716,5
Davidson,47037,1/13/2021,69513,335,66701,281,2812,54,81541,313,729499,2684,811040,2997,5,646,5,2193,711,7
Davidson,47037,1/12/2021,69178,376,66420,333,2758,43,81228,379,726815,2212,808043,2591,13,641,5,2188,704,6
Davidson,47037,1/11/2021,68802,341,66087,310,2715,31,80849,340,724603,1737,805452,2077,2,628,4,2183,698,9
Davidson,47037,1/10/2021,68461,556,65777,477,2684,79,80509,710,722866,3792,803375,4502,6,626,7,2179,689,9
Davidson,47037,1/9/2021,67905,680,65300,630,2605,50,79799,763,719074,4045,798873,4808,6,620,11,2172,680,11
Davidson,47037,1/8/2021,67225,619,64670,581,2555,38,79036,1003,715029,4622,794065,5625,14,614,6,2161,669,11
Davidson,47037,1/7/2021,66606,759,64089,725,2517,34,78033,655,710407,5064,788440,5719,0,600,7,2155,658,7
Davidson,47037,1/6/2021,65847,838,63364,738,2483,100,77378,878,705343,3576,782721,4454,0,600,5,2148,651,4
Davidson,47037,1/5/2021,65009,1093,62626,938,2383,155,76500,957,701767,3261,778267,4218,3,600,6,2143,647,7
Davidson,47037,1/4/2021,63916,431,61688,383,2228,48,75543,329,698506,1112,774049,1441,21,597,6,2137,640,2
Davidson,47037,1/3/2021,63485,227,61305,184,2180,43,75214,188,697394,790,772608,978,4,576,1,2131,638,6
Davidson,47037,1/2/2021,63258,644,61121,593,2137,51,75026,657,696604,2028,771630,2685,1,572,7,2130,632,5
Davidson,47037,1/1/2021,62614,575,60528,531,2086,44,74369,622,694576,2523,768945,3145,1,571,7,2123,627,9
Davidson,47037,12/31/2020,62039,661,59997,608,2042,53,73747,700,692053,3362,765800,4062,6,570,4,2116,618,2
Davidson,47037,12/30/2020,61378,714,59389,613,1989,101,73047,742,688691,2803,761738,3545,8,564,4,2112,616,4
Davidson,47037,12/29/2020,60664,971,58776,885,1888,86,72305,1061,685888,3211,758193,4272,7,556,15,2108,612,10
Davidson,47037,12/28/2020,59693,431,57891,396,1802,35,71244,426,682677,1370,753921,1796,8,549,8,2093,602,4
Davidson,47037,12/27/2020,59262,222,57495,201,1767,21,70818,235,681307,1153,752125,1388,3,541,2,2085,598,5
Davidson,47037,12/26/2020,59040,276,57294,257,1746,19,70583,306,680154,1746,750737,2052,0,538,9,2083,593,6
Davidson,47037,12/25/2020,58764,557,57037,511,1727,46,70277,642,678408,3032,748685,3674,1,538,4,2074,587,2
Davidson,47037,12/24/2020,58207,667,56526,612,1681,55,69635,750,675376,4727,745011,5477,8,537,6,2070,585,15
Davidson,47037,12/23/2020,57540,591,55914,501,1626,90,68885,598,670649,2920,739534,3518,4,529,9,2064,570,8
Davidson,47037,12/22/2020,56949,704,55413,656,1536,48,68287,786,667729,5531,736016,6317,7,525,13,2055,562,12
Davidson,47037,12/21/2020,56245,451,54757,409,1488,42,67501,483,662198,2234,729699,2717,15,518,9,2042,550,8
Davidson,47037,12/20/2020,55794,894,54348,831,1446,63,67018,1030,659964,7375,726982,8405,5,503,16,2033,542,5
Davidson,47037,12/19/2020,54900,726,53517,697,1383,29,65988,858,652589,5726,718577,6584,3,498,4,2017,537,5
Davidson,47037,12/18/2020,54174,697,52820,635,1354,62,65130,738,646863,3952,711993,4690,6,495,8,2013,532,7
Davidson,47037,12/17/2020,53477,859,52185,802,1292,57,64392,965,642911,4327,707303,5292,8,489,14,2005,525,7
Davidson,47037,12/16/2020,52618,728,51383,643,1235,85,63427,753,638584,3759,702011,4512,1,481,14,1991,518,3
Davidson,47037,12/15/2020,51890,965,50740,893,1150,72,62674,1060,634825,6042,697499,7102,-1,480,15,1977,515,2
Davidson,47037,12/14/2020,50925,784,49847,748,1078,36,61614,883,628783,4546,690397,5429,6,481,23,1962,513,5
Davidson,47037,12/13/2020,50141,859,49099,807,1042,52,60731,916,624237,5814,684968,6730,5,475,24,1939,508,5
Davidson,47037,12/12/2020,49282,831,48292,752,990,79,59815,890,618423,4685,678238,5575,9,470,16,1915,503,9
Davidson,47037,12/11/2020,48451,516,47540,499,911,17,58925,569,613738,3285,672663,3854,5,461,21,1899,494,6
Davidson,47037,12/10/2020,47935,785,47041,755,894,30,58356,903,610453,5670,668809,6573,2,456,17,1878,488,7
Davidson,47037,12/9/2020,47150,372,46286,328,864,44,57453,350,604783,1980,662236,2330,6,454,16,1861,481,2
Davidson,47037,12/8/2020,46778,706,45958,671,820,35,57103,769,602803,5036,659906,5805,8,448,16,1845,479,2
Davidson,47037,12/7/2020,46072,495,45287,479,785,16,56334,544,597767,3105,654101,3649,2,440,11,1829,477,5
Davidson,47037,12/6/2020,45577,318,44808,306,769,12,55790,361,594662,1249,650452,1610,3,438,2,1818,472,3
Davidson,47037,12/5/2020,45259,293,44502,274,757,19,55429,318,593413,3003,648842,3321,1,435,17,1816,469,5
Davidson,47037,12/4/2020,44966,558,44228,523,738,35,55111,600,590410,3109,645521,3709,5,434,7,1799,464,4
Davidson,47037,12/3/2020,44408,464,43705,447,703,17,54511,521,587301,3326,641812,3847,4,429,13,1792,460,6
Davidson,47037,12/2/2020,43944,296,43258,276,686,20,53990,326,583975,1688,637965,2014,2,425,4,1779,454,6
Davidson,47037,12/1/2020,43648,590,42982,554,666,36,53664,672,582287,4503,635951,5175,2,423,7,1775,448,5
Davidson,47037,11/30/2020,43058,531,42428,518,630,13,52992,618,577784,5630,630776,6248,1,421,7,1768,443,4
Davidson,47037,11/29/2020,42527,391,41910,379,617,12,52374,463,572154,5244,624528,5707,0,420,4,1761,439,1
Davidson,47037,11/28/2020,42136,438,41531,423,605,15,51911,497,566910,3951,618821,4448,1,420,10,1757,438,3
Davidson,47037,11/27/2020,41698,570,41108,556,590,14,51414,682,562959,4752,614373,5434,0,419,8,1747,435,3
Davidson,47037,11/26/2020,41128,727,40552,719,576,8,50732,862,558207,7386,608939,8248,7,419,7,1739,432,1
Davidson,47037,11/25/2020,40401,145,39833,115,568,30,49870,138,550821,2307,600691,2445,3,412,3,1732,431,3
Davidson,47037,11/24/2020,40256,54,39718,50,538,4,49732,54,548514,670,598246,724,2,409,4,1729,428,4
Davidson,47037,11/23/2020,40202,152,39668,146,534,6,49678,181,547844,1226,597522,1407,5,407,3,1725,424,2
Davidson,47037,11/22/2020,40050,562,39522,548,528,14,49497,652,546618,6412,596115,7064,2,402,14,1722,422,4
Davidson,47037,11/21/2020,39488,164,38974,156,514,8,48845,185,540206,1703,589051,1888,1,400,3,1708,418,5
Davidson,47037,11/20/2020,39324,464,38818,443,506,21,48660,517,538503,2892,587163,3409,6,399,4,1705,413,4
Davidson,47037,11/19/2020,38860,132,38375,124,485,8,48143,146,535611,1287,583754,1433,2,393,7,1701,409,5
Davidson,47037,11/18/2020,38728,291,38251,273,477,18,47997,344,534324,3246,582321,3590,1,391,10,1694,404,3
Davidson,47037,11/17/2020,38437,368,37978,366,459,2,47653,437,531078,2829,578731,3266,3,390,7,1684,401,1
Davidson,47037,11/16/2020,38069,513,37612,506,457,7,47216,597,528249,4814,575465,5411,5,387,17,1677,400,1
Davidson,47037,11/15/2020,37556,567,37106,547,450,20,46619,653,523435,8790,570054,9443,2,382,14,1660,399,2
Davidson,47037,11/14/2020,36989,378,36559,370,430,8,45966,431,514645,4295,560611,4726,1,380,7,1646,397,3
Davidson,47037,11/13/2020,36611,435,36189,424,422,11,45535,482,510350,3861,555885,4343,5,379,13,1639,394,3
Davidson,47037,11/12/2020,36176,233,35765,220,411,13,45053,258,506489,2853,551542,3111,0,374,3,1626,391,2
Davidson,47037,11/11/2020,35943,450,35545,436,398,14,44795,528,503636,4565,548431,5093,5,374,9,1623,389,2
Davidson,47037,11/10/2020,35493,376,35109,360,384,16,44267,418,499071,5935,543338,6353,3,369,11,1614,387,5
Davidson,47037,11/9/2020,35117,225,34749,219,368,6,43849,265,493136,2557,536985,2822,1,366,3,1603,382,3
Davidson,47037,11/8/2020,34892,394,34530,383,362,11,43584,423,490579,7386,534163,7809,0,365,9,1600,379,2
Davidson,47037,11/7/2020,34498,460,34147,453,351,7,43161,524,483193,4985,526354,5509,3,365,21,1591,377,0
Davidson,47037,11/6/2020,34038,384,33694,365,344,19,42637,440,478208,4714,520845,5154,2,362,8,1570,377,2
Davidson,47037,11/5/2020,33654,96,33329,85,325,11,42197,107,473494,1559,515691,1666,3,360,6,1562,375,3
Davidson,47037,11/4/2020,33558,265,33244,261,314,4,42090,311,471935,4303,514025,4614,2,357,6,1556,372,4
Davidson,47037,11/3/2020,33293,400,32983,397,310,3,41779,504,467632,4758,509411,5262,2,355,9,1550,368,3
Davidson,47037,11/2/2020,32893,214,32586,214,307,0,41275,274,462874,2690,504149,2964,1,353,6,1541,365,1
Davidson,47037,11/1/2020,32679,216,32372,206,307,10,41001,246,460184,5073,501185,5319,0,352,8,1535,364,0
Davidson,47037,10/31/2020,32463,3,32166,3,297,0,40755,3,455111,26,495866,29,2,352,0,1527,364,1
Davidson,47037,10/30/2020,32460,206,32163,201,297,5,40752,224,455085,2722,495837,2946,5,350,10,1527,363,6
Davidson,47037,10/29/2020,32254,175,31962,168,292,7,40528,198,452363,2184,492891,2382,-1,345,3,1517,357,2
Davidson,47037,10/28/2020,32079,232,31794,221,285,11,40330,273,450179,2913,490509,3186,5,346,11,1514,355,3
Davidson,47037,10/27/2020,31847,293,31573,286,274,7,40057,338,447266,5421,487323,5759,-2,341,14,1503,352,0
Davidson,47037,10/26/2020,31554,129,31287,127,267,2,39719,137,441845,1520,481564,1657,6,343,1,1489,352,0
Davidson,47037,10/25/2020,31425,289,31160,287,265,2,39582,381,440325,4947,479907,5328,1,337,10,1488,352,1
Davidson,47037,10/24/2020,31136,411,30873,406,263,5,39201,494,435378,6229,474579,6723,3,336,8,1478,351,1
Davidson,47037,10/23/2020,30725,228,30467,223,258,5,38707,256,429149,4421,467856,4677,3,333,11,1470,350,1
Davidson,47037,10/22/2020,30497,215,30244,209,253,6,38451,257,424728,3692,463179,3949,2,330,9,1459,349,2
Davidson,47037,10/21/2020,30282,147,30035,144,247,3,38194,174,421036,2024,459230,2198,2,328,4,1450,347,2
Davidson,47037,10/20/2020,30135,169,29891,162,244,7,38020,202,419012,3355,457032,3557,1,326,5,1446,345,2
Davidson,47037,10/19/2020,29966,264,29729,261,237,3,37818,291,415657,3458,453475,3749,0,325,8,1441,343,2
Davidson,47037,10/18/2020,29702,285,29468,281,234,4,37527,381,412199,7426,449726,7807,0,325,5,1433,341,0
Davidson,47037,10/17/2020,29417,247,29187,244,230,3,37146,278,404773,4237,441919,4515,1,325,8,1428,341,0
Davidson,47037,10/16/2020,29170,169,28943,165,227,4,36868,195,400536,2233,437404,2428,0,324,5,1420,341,2
Davidson,47037,10/15/2020,29001,114,28778,109,223,5,36673,140,398303,1890,434976,2030,1,324,7,1415,339,4
Davidson,47037,10/14/2020,28887,128,28669,123,218,5,36533,128,396413,2504,432946,2632,1,323,6,1408,335,4
Davidson,47037,10/13/2020,28759,131,28546,124,213,7,36405,150,393909,1832,430314,1982,1,322,6,1402,331,2
Davidson,47037,10/12/2020,28628,120,28422,119,206,1,36255,139,392077,3524,428332,3663,0,321,9,1396,329,1
Davidson,47037,10/11/2020,28508,224,28303,218,205,6,36116,267,388553,6711,424669,6978,0,321,17,1387,328,1
Davidson,47037,10/10/2020,28284,168,28085,166,199,2,35849,194,381842,4076,417691,4270,0,321,5,1370,327,1
Davidson,47037,10/9/2020,28116,122,27919,121,197,1,35655,154,377766,7707,413421,7861,2,321,1,1365,326,0
Davidson,47037,10/8/2020,27994,179,27798,173,196,6,35501,191,370059,3299,405560,3490,0,319,7,1364,326,1
Davidson,47037,10/7/2020,27815,107,27625,105,190,2,35310,119,366760,2767,402070,2886,2,319,12,1357,325,0
Davidson,47037,10/6/2020,27708,142,27520,141,188,1,35191,165,363993,2948,399184,3113,1,317,7,1345,325,0
Davidson,47037,10/5/2020,27566,165,27379,163,187,2,35026,186,361045,6043,396071,6229,0,316,5,1338,325,2
Davidson,47037,10/4/2020,27401,181,27216,173,185,8,34840,220,355002,5751,389842,5971,3,316,6,1333,323,1
Davidson,47037,10/3/2020,27220,122,27043,119,177,3,34620,151,349251,3895,383871,4046,0,313,3,1327,322,0
Davidson,47037,10/2/2020,27098,52,26924,51,174,1,34469,62,345356,1877,379825,1939,0,313,3,1324,322,1
Davidson,47037,10/1/2020,27046,42,26873,42,173,0,34407,50,343479,2353,377886,2403,1,313,1,1321,321,1
Davidson,47037,9/30/2020,27004,58,26831,55,173,3,34357,68,341126,1658,375483,1726,1,312,0,1320,320,2
Davidson,47037,9/29/2020,26946,120,26776,114,170,6,34289,148,339468,3030,373757,3178,4,311,2,1320,318,2
Davidson,47037,9/28/2020,26826,41,26662,39,164,2,34141,50,336438,1088,370579,1138,1,307,2,1318,316,1
Davidson,47037,9/27/2020,26785,89,26623,88,162,1,34091,109,335350,4976,369441,5085,0,306,4,1316,315,0
Davidson,47037,9/26/2020,26696,196,26535,196,161,0,33982,239,330374,6073,364356,6312,3,306,7,1312,315,2
Davidson,47037,9/25/2020,26500,84,26339,83,161,1,33743,104,324301,3439,358044,3543,5,303,3,1305,313,3
Davidson,47037,9/24/2020,26416,77,26256,73,160,4,33639,88,320862,3253,354501,3341,1,298,1,1302,310,1
Davidson,47037,9/23/2020,26339,55,26183,53,156,2,33551,70,317609,1317,351160,1387,3,297,1,1301,309,0
Davidson,47037,9/22/2020,26284,124,26130,119,154,5,33481,163,316292,3827,349773,3990,1,294,1,1300,309,2
Davidson,47037,9/21/2020,26160,46,26011,45,149,1,33318,52,312465,802,345783,854,4,293,5,1299,307,0
Davidson,47037,9/20/2020,26114,41,25966,40,148,1,33266,63,311663,2904,344929,2967,0,289,2,1294,307,1
Davidson,47037,9/19/2020,26073,153,25926,152,147,1,33203,192,308759,13887,341962,14079,2,289,6,1292,306,1
Davidson,47037,9/18/2020,25920,94,25774,93,146,1,33011,114,294872,4000,327883,4114,3,287,0,1286,305,2
Davidson,47037,9/17/2020,25826,129,25681,129,145,0,32897,151,290872,2368,323769,2519,0,284,4,1286,303,0
Davidson,47037,9/16/2020,25697,68,25552,65,145,3,32746,75,288504,1709,321250,1784,1,284,3,1282,303,1
Davidson,47037,9/15/2020,25629,152,25487,140,142,12,32671,179,286795,3166,319466,3345,2,283,2,1279,302,1
Davidson,47037,9/14/2020,25477,110,25347,104,130,6,32492,124,283629,1939,316121,2063,2,281,4,1277,301,3
Davidson,47037,9/13/2020,25367,86,25243,86,124,0,32368,143,281690,2104,314058,2247,2,279,1,1273,298,0
Davidson,47037,9/12/2020,25281,90,25157,89,124,1,32225,168,279586,3301,311811,3469,3,277,3,1272,298,2
Davidson,47037,9/11/2020,25191,70,25068,69,123,1,32057,89,276285,1647,308342,1736,0,274,1,1269,296,3
Davidson,47037,9/10/2020,25121,141,24999,138,122,3,31968,169,274638,3023,306606,3192,5,274,4,1268,293,2
Davidson,47037,9/9/2020,24980,90,24861,88,119,2,31799,137,271615,2669,303414,2806,2,269,4,1264,291,2
Davidson,47037,9/8/2020,24890,90,24773,90,117,0,31662,96,268946,2299,300608,2395,3,267,1,1260,289,2
Davidson,47037,9/7/2020,24800,43,24683,42,117,1,31566,62,266647,701,298213,763,0,264,3,1259,287,1
Davidson,47037,9/6/2020,24757,106,24641,104,116,2,31504,114,265946,848,297450,962,0,264,1,1256,286,1
Davidson,47037,9/5/2020,24651,326,24537,325,114,1,31390,389,265098,4262,296488,4651,3,264,5,1255,285,2
Davidson,47037,9/4/2020,24325,55,24212,55,113,0,31001,64,260836,968,291837,1032,2,261,0,1250,283,2
Davidson,47037,9/3/2020,24270,66,24157,64,113,2,30937,79,259868,1628,290805,1707,-1,259,1,1250,281,2
Davidson,47037,9/2/2020,24204,56,24093,52,111,4,30858,79,258240,2168,289098,2247,1,260,3,1249,279,1
Davidson,47037,9/1/2020,24148,113,24041,110,107,3,30779,180,256072,3568,286851,3748,0,259,3,1246,278,3
Davidson,47037,8/31/2020,24035,81,23931,79,104,2,30599,116,252504,1641,283103,1757,1,259,1,1243,275,1
Davidson,47037,8/30/2020,23954,26,23852,26,102,0,30483,34,250863,448,281346,482,3,258,4,1242,274,2
Davidson,47037,8/29/2020,23928,62,23826,62,102,0,30449,79,250415,1288,280864,1367,1,255,3,1238,272,1
Davidson,47037,8/28/2020,23866,108,23764,107,102,1,30370,148,249127,1704,279497,1852,3,254,6,1235,271,2
Davidson,47037,8/27/2020,23758,158,23657,156,101,2,30222,222,247423,3565,277645,3787,1,251,5,1229,269,1
Davidson,47037,8/26/2020,23600,118,23501,118,99,0,30000,147,243858,2269,273858,2416,1,250,5,1224,268,3
Davidson,47037,8/25/2020,23482,148,23383,148,99,0,29853,231,241589,3793,271442,4024,3,249,3,1219,265,2
Davidson,47037,8/24/2020,23334,32,23235,32,99,0,29622,39,237796,733,267418,772,1,246,0,1216,263,2
Davidson,47037,8/23/2020,23302,65,23203,65,99,0,29583,78,237063,1303,266646,1381,0,245,3,1216,261,2
Davidson,47037,8/22/2020,23237,141,23138,137,99,4,29505,209,235760,5580,265265,5789,0,245,7,1213,259,0
Davidson,47037,8/21/2020,23096,9,23001,9,95,0,29296,13,230180,1470,259476,1483,3,245,0,1206,259,1
Davidson,47037,8/20/2020,23087,194,22992,191,95,3,29283,251,228710,4792,257993,5043,7,242,5,1206,258,1
Davidson,47037,8/19/2020,22893,131,22801,128,92,3,29032,186,223918,3279,252950,3465,4,235,6,1201,257,1
Davidson,47037,8/18/2020,22762,208,22673,206,89,2,28846,349,220639,5414,249485,5763,1,231,5,1195,256,3
Davidson,47037,8/17/2020,22554,77,22467,67,87,10,28497,88,215225,876,243722,964,3,230,9,1190,253,1
Davidson,47037,8/16/2020,22477,172,22400,164,77,8,28409,237,214349,2093,242758,2330,7,227,8,1181,252,0
Davidson,47037,8/15/2020,22305,208,22236,200,69,8,28172,296,212256,2853,240428,3149,-1,220,11,1173,252,3
Davidson,47037,8/14/2020,22097,113,22036,110,61,3,27876,127,209403,616,237279,743,0,221,9,1162,249,3
Davidson,47037,8/13/2020,21984,307,21926,302,58,5,27749,443,208787,4936,236536,5379,0,221,22,1153,246,0
Davidson,47037,8/12/2020,21677,75,21624,74,53,1,27306,100,203851,902,231157,1002,2,221,3,1131,246,2
Davidson,47037,8/11/2020,21602,266,21550,261,52,5,27206,339,202949,3298,230155,3637,2,219,7,1128,244,0
Davidson,47037,8/10/2020,21336,86,21289,84,47,2,26867,98,199651,813,226518,911,4,217,4,1121,244,3
Davidson,47037,8/9/2020,21250,118,21205,118,45,0,26769,142,198838,1258,225607,1400,0,213,8,1117,241,1
Davidson,47037,8/8/2020,21132,225,21087,222,45,3,26627,293,197580,2859,224207,3152,1,213,9,1109,240,2
Davidson,47037,8/7/2020,20907,254,20865,254,42,0,26334,336,194721,2642,221055,2978,1,212,5,1100,238,2
Davidson,47037,8/6/2020,20653,243,20611,242,42,1,25998,314,192079,2686,218077,3000,3,211,9,1095,236,1
Davidson,47037,8/5/2020,20410,126,20369,125,41,1,25684,149,189393,1256,215077,1405,3,208,7,1086,235,1
Davidson,47037,8/4/2020,20284,214,20244,214,40,0,25535,317,188137,2606,213672,2923,3,205,10,1079,234,4
Davidson,47037,8/3/2020,20070,143,20030,143,40,0,25218,183,185531,1737,210749,1920,3,202,4,1069,230,2
Davidson,47037,8/2/2020,19927,90,19887,90,40,0,25035,118,183794,1024,208829,1142,1,199,6,1065,228,6
Davidson,47037,8/1/2020,19837,249,19797,249,40,0,24917,348,182770,2995,207687,3343,0,198,12,1059,222,6
Davidson,47037,7/31/2020,19588,81,19548,80,40,1,24569,106,179775,1523,204344,1629,3,198,7,1047,216,2
Davidson,47037,7/30/2020,19507,325,19468,325,39,0,24463,498,178252,4238,202715,4736,1,195,13,1040,214,2
Davidson,47037,7/29/2020,19182,64,19143,63,39,1,23965,88,174014,982,197979,1070,0,194,5,1027,212,6
Davidson,47037,7/28/2020,19118,273,19080,270,38,3,23877,419,173032,2974,196909,3393,6,194,15,1022,206,1
Davidson,47037,7/27/2020,18845,208,18810,204,35,4,23458,306,170058,1984,193516,2290,2,188,13,1007,205,1
Davidson,47037,7/26/2020,18637,278,18606,277,31,1,23152,401,168074,2758,191226,3159,0,186,11,994,204,5
Davidson,47037,7/25/2020,18359,338,18329,337,30,1,22751,498,165316,3831,188067,4329,7,186,24,983,199,2
Davidson,47037,7/24/2020,18021,280,17992,278,29,2,22253,446,161485,3143,183738,3589,0,179,9,959,197,7
Davidson,47037,7/23/2020,17741,296,17714,296,27,0,21807,408,158342,3928,180149,4336,6,179,12,950,190,5
Davidson,47037,7/22/2020,17445,193,17418,192,27,1,21399,256,154414,1511,175813,1767,1,173,14,938,185,5
Davidson,47037,7/21/2020,17252,580,17226,580,26,0,21143,796,152903,5800,174046,6596,6,172,22,924,180,0
Davidson,47037,7/20/2020,16672,115,16646,114,26,1,20347,178,147103,944,167450,1122,0,166,5,902,180,3
Davidson,47037,7/19/2020,16557,215,16532,215,25,0,20169,305,146159,2104,166328,2409,0,166,11,897,177,1
Davidson,47037,7/18/2020,16342,351,16317,350,25,1,19864,487,144055,3798,163919,4285,2,166,6,886,176,5
Davidson,47037,7/17/2020,15991,384,15967,382,24,2,19377,512,140257,2922,159634,3434,4,164,12,880,171,1
Davidson,47037,7/16/2020,15607,512,15585,511,22,1,18865,682,137335,4842,156200,5524,3,160,18,868,170,2
Davidson,47037,7/15/2020,15095,341,15074,340,21,1,18183,416,132493,2244,150676,2660,2,157,15,850,168,2
Davidson,47037,7/14/2020,14754,327,14734,327,20,0,17767,418,130249,2833,148016,3251,9,155,15,835,166,0
Davidson,47037,7/13/2020,14427,401,14407,401,20,0,17349,493,127416,2562,144765,3055,3,146,9,820,166,4
Davidson,47037,7/12/2020,14026,457,14006,457,20,0,16856,578,124854,3381,141710,3959,0,143,15,811,162,3
Davidson,47037,7/11/2020,13569,198,13549,198,20,0,16278,230,121473,1260,137751,1490,1,143,6,796,159,2
Davidson,47037,7/10/2020,13371,530,13351,528,20,2,16048,646,120213,2826,136261,3472,4,142,16,790,157,4
Davidson,47037,7/9/2020,12841,278,12823,278,18,0,15402,370,117387,2438,132789,2808,6,138,20,774,153,3
Davidson,47037,7/8/2020,12563,370,12545,370,18,0,15032,468,114949,3151,129981,3619,5,132,14,754,150,1
Davidson,47037,7/7/2020,12193,593,12175,593,18,0,14564,727,111798,3975,126362,4702,6,127,24,740,149,6
Davidson,47037,7/6/2020,11600,209,11582,208,18,1,13837,260,107823,1272,121660,1532,-1,121,4,716,143,4
Davidson,47037,7/5/2020,11391,310,11374,309,17,1,13577,406,106551,2341,120128,2747,4,122,6,712,139,4
Davidson,47037,7/4/2020,11081,367,11065,367,16,0,13171,449,104210,3026,117381,3475,0,118,13,706,135,2
Davidson,47037,7/3/2020,10714,306,10698,303,16,3,12722,362,101184,2091,113906,2453,3,118,10,693,133,2
Davidson,47037,7/2/2020,10408,372,10395,372,13,0,12360,454,99093,3357,111453,3811,1,115,14,683,131,2
Davidson,47037,7/1/2020,10036,375,10023,375,13,0,11906,432,95736,2379,107642,2811,1,114,12,669,129,4
Davidson,47037,6/30/2020,9661,535,9648,534,13,1,11474,637,93357,3414,104831,4051,3,113,12,657,125,1
Davidson,47037,6/29/2020,9126,286,9114,285,12,1,10837,337,89943,1937,100780,2274,0,110,8,645,124,4
Davidson,47037,6/28/2020,8840,179,8829,179,11,0,10500,200,88006,1474,98506,1674,0,110,2,637,120,2
Davidson,47037,6/27/2020,8661,18,8650,18,11,0,10300,26,86532,110,96832,136,5,110,2,635,118,0
Davidson,47037,6/26/2020,8643,177,8632,177,11,0,10274,219,86422,1162,96696,1381,2,105,6,633,118,4
Davidson,47037,6/25/2020,8466,263,8455,263,11,0,10055,294,85260,2280,95315,2574,1,103,7,627,114,2
Davidson,47037,6/24/2020,8203,187,8192,187,11,0,9761,225,82980,869,92741,1094,4,102,15,620,112,2
Davidson,47037,6/23/2020,8016,285,8005,285,11,0,9536,324,82111,1762,91647,2086,2,98,10,605,110,2
Davidson,47037,6/22/2020,7731,82,7720,80,11,2,9212,104,80349,1224,89561,1328,1,96,10,595,108,2
Davidson,47037,6/21/2020,7649,92,7640,92,9,0,9108,116,79125,937,88233,1053,0,95,3,585,106,1
Davidson,47037,6/20/2020,7557,89,7548,89,9,0,8992,114,78188,876,87180,990,0,95,4,582,105,1
Davidson,47037,6/19/2020,7468,180,7459,180,9,0,8878,254,77312,1697,86190,1951,2,95,5,578,104,3
Davidson,47037,6/18/2020,7288,261,7279,261,9,0,8624,331,75615,1749,84239,2080,2,93,27,573,101,2
Davidson,47037,6/17/2020,7027,48,7018,48,9,0,8293,64,73866,882,82159,946,1,91,4,546,99,1
Davidson,47037,6/16/2020,6979,143,6970,143,9,0,8229,171,72984,903,81213,1074,2,90,5,542,98,0
Davidson,47037,6/15/2020,6836,137,6827,137,9,0,8058,179,72081,1071,80139,1250,4,88,11,537,98,1
Davidson,47037,6/14/2020,6699,151,6690,151,9,0,7879,189,71010,1915,78889,2104,0,84,6,526,97,3
Davidson,47037,6/13/2020,6548,151,6539,151,9,0,7690,169,69095,1419,76785,1588,0,84,7,520,94,2
Davidson,47037,6/12/2020,6397,88,6388,88,9,0,7521,108,67676,663,75197,771,3,84,13,513,92,1
Davidson,47037,6/11/2020,6309,88,6300,88,9,0,7413,116,67013,1069,74426,1185,1,81,4,500,91,0
Davidson,47037,6/10/2020,6221,75,6212,74,9,1,7297,104,65944,603,73241,707,0,80,12,496,91,0
Davidson,47037,6/9/2020,6146,163,6138,163,8,0,7193,194,65341,1116,72534,1310,7,80,7,484,91,2
Davidson,47037,6/8/2020,5983,89,5975,89,8,0,6999,107,64225,817,71224,924,0,73,1,477,89,1
Davidson,47037,6/7/2020,5894,125,5886,125,8,0,6892,155,63408,1401,70300,1556,0,73,10,476,88,2
Davidson,47037,6/6/2020,5769,103,5761,103,8,0,6737,128,62007,888,68744,1016,4,73,4,466,86,4
Davidson,47037,6/5/2020,5666,122,5658,122,8,0,6609,158,61119,1269,67728,1427,3,69,5,462,82,1
Davidson,47037,6/4/2020,5544,34,5536,34,8,0,6451,41,59850,613,66301,654,1,66,5,457,81,1
Davidson,47037,6/3/2020,5510,75,5502,75,8,0,6410,102,59237,831,65647,933,1,65,10,452,80,3
Davidson,47037,6/2/2020,5435,179,5427,179,8,0,6308,206,58406,1693,64714,1899,2,64,7,442,77,1
Davidson,47037,6/1/2020,5256,83,5248,83,8,0,6102,94,56713,772,62815,866,0,62,3,435,76,2
Davidson,47037,5/31/2020,5173,119,5165,119,8,0,6008,151,55941,1692,61949,1843,0,62,14,432,74,1
Davidson,47037,5/30/2020,5054,81,5046,81,8,0,5857,102,54249,714,60106,816,3,62,2,418,73,0
Davidson,47037,5/29/2020,4973,32,4965,30,8,2,5755,39,53535,727,59290,766,-1,59,0,416,73,2
Davidson,47037,5/28/2020,4941,127,4935,127,6,0,5716,156,52808,615,58524,771,0,60,4,416,71,2
Davidson,47037,5/27/2020,4814,20,4808,19,6,1,5560,23,52193,742,57753,765,0,60,3,412,69,1
Davidson,47037,5/26/2020,4794,78,4789,77,5,1,5537,92,51451,730,56988,822,2,60,3,409,68,1
Davidson,47037,5/25/2020,4716,188,4712,188,4,0,5445,222,50721,1566,56166,1788,1,58,5,406,67,2
Davidson,47037,5/24/2020,4528,67,4524,67,4,0,5223,80,49155,1066,54378,1146,3,57,5,401,65,3
Davidson,47037,5/23/2020,4461,72,4457,72,4,0,5143,95,48089,1262,53232,1357,6,54,4,396,62,1
Davidson,47037,5/22/2020,4389,79,4385,79,4,0,5048,103,46827,1079,51875,1182,0,48,5,392,61,1
Davidson,47037,5/21/2020,4310,45,4306,45,4,0,4945,45,45748,364,50693,409,0,48,1,387,60,1
Davidson,47037,5/20/2020,4265,61,4261,61,4,0,4900,80,45384,1023,50284,1103,2,48,4,386,59,0
Davidson,47037,5/19/2020,4204,90,4200,90,4,0,4820,130,44361,970,49181,1100,2,46,7,382,59,2
Davidson,47037,5/18/2020,4114,96,4110,96,4,0,4690,116,43391,883,48081,999,0,44,5,375,57,2
Davidson,47037,5/17/2020,4018,159,4014,159,4,0,4574,191,42508,2253,47082,2444,3,44,8,370,55,1
Davidson,47037,5/16/2020,3859,76,3855,76,4,0,4383,94,40255,788,44638,882,0,41,3,362,54,1
Davidson,47037,5/15/2020,3783,28,3779,28,4,0,4289,41,39467,421,43756,462,1,41,2,359,53,3
Davidson,47037,5/14/2020,3755,57,3751,57,4,0,4248,77,39046,1292,43294,1369,3,40,5,357,50,4
Davidson,47037,5/13/2020,3698,109,3694,109,4,0,4171,126,37754,707,41925,833,4,37,5,352,46,3
Davidson,47037,5/12/2020,3589,76,3585,76,4,0,4045,97,37047,1729,41092,1826,1,33,7,347,43,1
Davidson,47037,5/11/2020,3513,76,3509,75,4,1,3948,87,35318,817,39266,904,1,32,3,340,42,1
Davidson,47037,5/10/2020,3437,42,3434,42,3,0,3861,69,34501,922,38362,991,0,31,0,337,41,1
Davidson,47037,5/9/2020,3395,62,3392,62,3,0,3792,74,33579,957,37371,1031,0,31,1,337,40,1
Davidson,47037,5/8/2020,3333,38,3330,37,3,1,3718,59,32622,543,36340,602,0,31,6,336,39,1
Davidson,47037,5/7/2020,3295,127,3293,127,2,0,3659,144,32079,3021,35738,3165,0,31,7,330,38,0
Davidson,47037,5/6/2020,3168,68,3166,68,2,0,3515,88,29058,883,32573,971,1,31,2,323,38,0
Davidson,47037,5/5/2020,3100,35,3098,35,2,0,3427,53,28175,681,31602,734,1,30,9,321,38,2
Davidson,47037,5/4/2020,3065,117,3063,117,2,0,3374,131,27494,813,30868,944,1,29,7,312,36,1
Davidson,47037,5/3/2020,2948,154,2946,154,2,0,3243,171,26681,1039,29924,1210,0,28,8,305,35,2
Davidson,47037,5/2/2020,2794,43,2792,43,2,0,3072,63,25642,418,28714,481,0,28,5,297,33,1
Davidson,47037,5/1/2020,2751,128,2749,128,2,0,3009,150,25224,1445,28233,1595,0,28,5,292,32,0
Davidson,47037,4/30/2020,2623,48,2621,48,2,0,2859,58,23779,317,26638,375,3,28,7,287,32,2
Davidson,47037,4/29/2020,2575,150,2573,150,2,0,2801,170,23462,1292,26263,1462,0,25,11,280,30,1
Davidson,47037,4/28/2020,2425,42,2423,42,2,0,2631,54,22170,297,24801,351,0,25,8,269,29,1
Davidson,47037,4/27/2020,2383,90,2381,90,2,0,2577,98,21873,782,24450,880,2,25,6,261,28,0
Davidson,47037,4/26/2020,2293,72,2291,72,2,0,2479,85,21091,595,23570,680,1,23,7,255,28,1
Davidson,47037,4/25/2020,2221,64,2219,64,2,0,2394,77,20496,401,22890,478,1,22,10,248,27,1
Davidson,47037,4/24/2020,2157,165,2155,165,2,0,2317,184,20095,1483,22412,1667,0,21,19,238,26,0
Davidson,47037,4/23/2020,1992,38,1990,38,2,0,2133,39,18612,256,20745,295,1,21,5,219,26,3
Davidson,47037,4/22/2020,1954,150,1952,150,2,0,2094,164,18356,1156,20450,1320,0,20,8,214,23,0
Davidson,47037,4/21/2020,1804,45,1802,45,2,0,1930,55,17200,301,19130,356,1,20,4,206,23,0
Davidson,47037,4/20/2020,1759,36,1757,36,2,0,1875,41,16899,1055,18774,1096,0,19,5,202,23,1
Davidson,47037,4/19/2020,1723,100,1721,99,2,1,1834,115,15844,490,17678,605,0,19,3,197,22,0
Davidson,47037,4/18/2020,1623,46,1622,46,1,0,1719,52,15354,503,17073,555,0,19,2,194,22,1
Davidson,47037,4/17/2020,1577,125,1576,125,1,0,1667,133,14851,667,16518,800,0,19,14,192,21,0
Davidson,47037,4/16/2020,1452,44,1451,44,1,0,1534,44,14184,228,15718,272,0,19,3,178,21,2
Davidson,47037,4/15/2020,1408,75,1407,75,1,0,1490,82,13956,453,15446,535,1,19,3,175,19,1
Davidson,47037,4/14/2020,1333,42,1332,42,1,0,1408,51,13503,204,14911,255,2,18,9,172,18,1
Davidson,47037,4/13/2020,1291,58,1290,57,1,1,1357,66,13299,476,14656,542,3,16,8,163,17,2
Davidson,47037,4/12/2020,1233,36,1233,36,0,0,1291,38,12823,335,14114,373,0,13,5,155,15,1
Davidson,47037,4/11/2020,1197,76,1197,76,0,0,1253,80,12488,709,13741,789,0,13,10,150,14,1
Davidson,47037,4/10/2020,1121,28,1121,28,0,0,1173,29,11779,298,12952,327,0,13,4,140,13,0
Davidson,47037,4/9/2020,1093,64,1093,64,0,0,1144,69,11481,505,12625,574,0,13,8,136,13,0
Davidson,47037,4/8/2020,1029,40,1029,40,0,0,1075,48,10976,457,12051,505,4,13,5,128,13,0
Davidson,47037,4/7/2020,989,44,989,44,0,0,1027,45,10519,460,11546,505,2,9,10,123,13,2
Davidson,47037,4/6/2020,945,46,945,46,0,0,982,47,10059,769,11041,816,1,7,7,113,11,1
Davidson,47037,4/5/2020,899,94,899,94,0,0,935,113,9290,1053,10225,1166,0,6,8,106,10,1
Davidson,47037,4/4/2020,805,39,805,39,0,0,822,44,8237,632,9059,676,0,6,4,98,9,1
Davidson,47037,4/3/2020,766,72,766,72,0,0,778,75,7605,498,8383,573,0,6,17,94,8,1
Davidson,47037,4/2/2020,694,43,694,43,0,0,703,45,7107,584,7810,629,2,6,6,77,7,0
Davidson,47037,4/1/2020,651,82,651,82,0,0,658,87,6523,639,7181,726,0,0,10,71,7,2
Davidson,47037,3/31/2020,569,74,569,74,0,0,571,77,5884,619,6455,696,0,0,4,61,5,0
Davidson,47037,3/30/2020,495,105,495,105,0,0,494,106,5265,1152,5759,1258,0,0,9,57,5,1
Davidson,47037,3/29/2020,390,15,390,15,0,0,388,17,4113,47,4501,64,0,0,4,48,4,0
Davidson,47037,3/28/2020,375,54,375,54,0,0,371,51,4066,371,4437,422,0,0,15,44,4,1
Davidson,47037,3/27/2020,321,49,321,49,0,0,320,55,3695,418,4015,473,0,0,6,29,3,0
Davidson,47037,3/26/2020,272,26,272,26,0,0,265,27,3277,355,3542,382,0,0,2,23,3,2
Davidson,47037,3/25/2020,246,25,246,25,0,0,238,25,2922,228,3160,253,0,0,3,21,1,0
Davidson,47037,3/24/2020,221,8,221,8,0,0,213,9,2694,133,2907,142,0,0,1,18,1,0
Davidson,47037,3/23/2020,213,25,213,25,0,0,204,22,2561,229,2765,251,0,0,2,17,1,0
Davidson,47037,3/22/2020,188,40,188,40,0,0,182,35,2332,297,2514,332,0,0,5,15,1,0
Davidson,47037,3/21/2020,148,55,148,55,0,0,147,31,2035,433,2182,464,0,0,4,10,1,0
Davidson,47037,3/20/2020,93,88,93,88,0,0,116,22,1602,327,1718,349,0,0,5,6,1,1
Davidson,47037,3/19/2020,5,3,5,3,0,0,94,33,1275,293,1369,326,0,0,1,1,0,0
Davidson,47037,3/18/2020,2,1,2,1,0,0,61,17,982,223,1043,240,0,0,0,0,0,0
Davidson,47037,3/17/2020,1,1,1,1,0,0,44,32,759,581,803,613,0,0,0,0,0,0
Davidson,47037,3/16/2020,0,0,0,0,0,0,12,0,178,44,190,44,0,0,0,0,0,0
Davidson,47037,3/15/2020,0,0,0,0,0,0,12,0,134,5,146,5,0,0,0,0,0,0
Davidson,47037,3/14/2020,0,0,0,0,0,0,12,12,129,118,141,130,0,0,0,0,0,0
Davidson,47037,3/13/2020,0,0,0,0,0,0,0,0,11,6,11,6,0,0,0,0,0,0
Davidson,47037,3/12/2020,0,0,0,0,0,0,0,0,5,5,5,5,0,0,0,0,0,0
